Un perro está con un juguete .	Un perro tiene un juguete .
Los niños acarician un conejito .	Los niños acarician un perro .
La gente cocina en la parrilla .	Los peatones miran con asombro mientras dos personas cocinan pechuga en una parrilla .
El hombre construye un pequeño castillo de arena	Una muchacha está construyendo un castillo de arena .
Un hombre está corriendo detrás de un trineo tirado por cuatro perros .	Un hombre siendo tirado en un trineo por perros .
Una persona haciendo rapel .	Una persona esta haciendo rapel
La gente está esperando piezas de autos .	La gente está esperando por el auto .
El hombre está emocionado , ya que esta es su primera presentación para su nueva empresa .	Un hombre está tocando un instrumento que él creó por dinero en la calle .
Una muchacha en un vestido rosado está parada de cabeza .	Una mujer de rosado está cubriendo su rostro con una bufanda .
Un hombre está apilando grupos de rocas junto al mar .	La banda está tocando dentro de un pequeño club nocturno .
Un hombre vestido sólo con una toalla está de pie fuera cerca del agua .	Un hombre se está sentando delante de una fuente de agua
El libro que se lee es Harry Potter	El hombre está leyendo un libro de Harry Potter .
Hombre con traje escocés tocando la gaita en un día lluvioso en la acera .	Dos niñas balanceándose de lado a lado en un parque en un día cálido .
Ciclista en un bosque cubierto de nieve en la noche	El esquiador está cerca del suelo cubierto de nieve .
Un hombre toma la foto de una muchacha y ella está cerca del agua .	Una muchacha se está exhibiendo delante de su amigo .
Una dama está cantando	Una dama cantando .
El hombre es un artista callejero y tiene gente viendo sus trucos	Un joven surfea una gran ola mientras que otros están quietos en el fondo .
Un capitán recibiendo un premio .	Después de una gran actuación , el hombre recibe una ovación de pie después de recibir un premio .
El hombre está montando un monociclo con un loro en su hombro	Una mujer está montando en su bicicleta con un casco puesto .
Un niño pequeño está sosteniendo un anillo de bodas .	Un niño pequeño en un traje sostiene el anillo para una boda .
Cada persona que se muestra está sosteniendo un cachorro .	Una persona está hablando .
La muchacha está disfrutando del día .	La mujer está celebrando Año Nuevo .
Un joven manifestante sostiene un letrero contra la guerra .	Una hombre saludando con la mano mientras da un discurso .
Una pareja está sentanda en el césped con sus pies cruzados , y se están besando .	El hombre y la mujer se alejan uno del otro .
El agua está muy caliente .	El agua de la piscina está muy fría .
Dos guitarristas a ambos lados de un escenario y un baterista detrás de una batería roja en el centro .	Una banda colocada en el escenario , con el guitarrista y el bajista delante
La gente está a punto de comprar una pintura en una feria .	Un par de personas en un museo mirando en la tienda de regalos , potencialmente va a comprar algo .
Un grupo de niñas que llevan pañuelos en la cabeza posan para una foto grupal .	Una niña con un paraguas rojo y pintura de la cara de pie junto a otras chicas .
Un desfile en el cual hay una mujer vestida de blanco sobre zancos .	Hay una muchacha en un vestido rojo de pie en el muelle .
un chico joven canta a una bola de baseball fuera del campo de golf	Un hombre y un niño están jugando en el agua .
Una mujer sientiéndose asustada en un caballo en una montaña cubierta de nieve	Una niña sentada en la nieve
Dos hombres en trajes rojos practicando artes marciales .	Dos hombre en uniformes de artes marciales entrenando .
La gente está de pie en público .	La gente está en público .
Una patinadora en una sudadera negra con capucha ejecutando un estupendo rail grind en su patineta .	Una patinadora en una sudadera blanca con capucha ejecutando un estupendo rail grind en su patineta .
Una muchacha con pantalón rosado jugando en el suelo .	Un niño con pantalón azul juega en el suelo
Juego nocturno en la pequeña liga	Jugadores de fútbol en el día del juego .
Una mujer de rosado está sosteniendo a su hija .	Una mujer está caminando con su hija .
La gente está viendo un concierto de rap dentro del estadio yankee	La multitud se vuelve loca por la banda
Un hombre está viendo un pequeño televisor en la hornacina de un edificio rojo .	Un niño con un globo verde está de pie fuera de un edificio grande .
Padre e hijo que visten atuendos de vaqueros iguales está viendo un rodeo .	Un pequeño niño y su padre están usando camisas de cuadros azules y viendo un rodeo .
Un hombre está sosteniendo un letrero de publicidad .	Un hombre está sosteniendo un letrero para un restaurante .
La chaqueta está hecha de cuero	La chaqueta está hecha de cuero
Tres mujeres están de pie juntas .	Dos mujeres están de pie juntas .
Niña jugando con su muñeca	Una madre juega peekaboo con su bebé
Un hombre muestra alguna ropa mientras usa zapatos azules .	Un hombre y una mujer están usando sombreros de colores diferentes para su cita .
Tres mujeres tejiendo medias	Las mujeres están cosiendo y tejiendo mantas de bebé .
Una niño está dentro .	Una niño está dentro .
Una mujer en una camisa a rayas sube una montaña .	Un hombre en una chaqueta roja subiendo una montaña
Un hombre con un bigote toca el saxofón .	Un hombre con una barba toca la guitarra .
Un niño está conduciendo un pequeño auto de carreras .	Un niño está montando una bicicleta .
El hombre lanzó un palo .	El hombre lanza un palo .
El hombre viste un suéter azul y está descalzo en una cancha .	El hombre está de pie en una tienda vistiendo una camisa azul .
El reflejo de la anciana puede ser visto en un charco .	Una mujer está de pie en una multitud pero nadie puede verla porque ella es un fantasma .
Tres hombres conversando seriamente en Walmart .	Tres mujeres que se quedan por la noche .
Un aficionado está trando de atrapar una pelota en foul	Un hombre está paralelo en el aire , tratando de patear el balón de fútbol más allá del arquero .
Hay una pelota cerca del campo haciendo donde corren los jugadores	Los muchachos están afuera en un campo .
La mujer está vendiendo muñecas que parecen barbies .	El lindo bebé está jugando con un juguete .
Una mujer está llamando a su amiga .	Un hombre está llamando a su enamorada .
Un profesor de arte ayudando a un estudiante .	Un profesor ayuda a un estudiante en la clase de carpintería .
Un hombre está preparándose para correr una maratón .	Un hombre corriendo para un maratón .
Un desconocido está durmiendo en una galería de arte .	Una mujer está dentro de un museo de arte .
Personas teniendo una barbacoa	La gente está en casa cenando .
Un niño está abriendo la caja que contiene a su nuevo perrito .	Un hombre está haciendo un truco en un tablero .
Todos estaban corriendo	Él va rápido .
Una orquesta está afinando para un ensayo privado .	Una pequeña orquesta tocando para una audiencia .
Un perro juega en un campo .	Un perro jugando en un campo .
Un niño tranquiliza a un perro grande .	Un niño lanza algo para que un perro blanco lo atrape .
Dos hombres juegan cricket afuera .	Dos hombres juegan cricket .
Un hombre está operando maquinaria .	El hombre está operando una maquinaria .
El hombre está caminando con su bicicleta .	El hombre está caminando su bicicleta .
3 jugadores de baloncesto están tratando de ganar un juego	Dos equipos de jugadores de fútbol no comienzan un juego
Dos hombres están teniendo un día de descanso .	Cuatro hombres están teniendo una conversación .
Imagina mirando a un ciclista de maratón en su bicicleta , bajando por un pasillo de gente .	Un hombre está tratando de montar cuatro bicicletas al mismo tiempo .
El verano realmente es agradable .	Una pareja está disfrutando del buen día .
La gente deja caer las banderas .	La gente está cerca a la bandera .
Una multitud se prepara para un evento .	Una multitud está esperando que comience un evento .
El hombre compró solo	El hombre leyó solo afuera
Un pequeño perro lleva un lazo por la calle .	Un pequeño perro saltando en la calle .
Los empresarios están reunidos para discutir sus últimas iniciativas .	Dos hombres están discutiendo su reunión de negocios .
Un grupo de personas hablan mientras se acurrucan en la calle	Grupo de personas reunidas como en una reunión con comida delante de ellos .
Una mujer comparte su paraguas .	Un hombre y una mujer de la mano .
Una persona está subiendo un asta para asegurar la bandera mientras que la gente mira .	Una persona bajando de la montaña .
Un hombre esquivando adversarios con una bola de basquet mientras otro hombre observa	Un hombre de mediana edad está a punto de golpear una pelota de tenis con su raqueta .
Una mujer cosechando sus cultivos en un área pantanosa .	Una mujer usando una azada cerca de sus cultivos en una granja
Un hombre triste colocando material negro en la calle .	Un hombre colocando material negro en la calle .
Una serie de personas de pie cerca a una estatua de un toro .	Una estatua de oro de una hombre mientras que gente camina frente a un bar de restaurante .
Un hombre y su perro en la cima de una montaña .	Un hombre encima de un caballo .
Una niña llevando un vestido en una boda .	Una mujer llevando un vestido y un hombre llevando una camiseta sentados al lado del arte .
Un hombre en una bicicleta hace un backflip .	Alguien está haciendo un backflip en una bicicleta .
Un hombre corriendo en una corredora	Un hombre está caminando en una corredora
Él estaba cerca de un puente .	El anciano estaba cerca del fuego .
Personas ancianas ayudándonse los unos a los otros	El hombre está revisando sus acciones antes de hacer un comentario a las otras personas .
Un hombre está corriendo de prisa en la calle .	El hombre está manejando una bicicleta en la calle .
Los hombres están en huelga .	Los dos hombres están apagando el fuego .
Dos hombres observan una reacción química .	Un grupo de hombres está afuera con armas .
Una multitud está mirando a un hombre en el escenario .	Un hombre canta solo en el escenario para una multitud .
Un grupo está actuando para unos niños	Un grupo de niños miran a un grupo de adultos .
Dama en un top oscuro , falta con impresioes , medias rojas y zapatos caminando	Mujer caminando en la calle con tacones altos , leggins negros , abrigo negro y cartera roja
Una mujer está usando una red para pescar en el río .	Un pez está saltando fuera del agua para atrapar una mosca .
Puede haber una mujer bajo una imagen de Jesús .	Hay una persona en la fotografía .
La señora mayor está usando lentes de sol para proteger sus ojos del sol brillante .	Este hombre usa lentes de sol para mantener el sol fuera alejado de sus ojos
Una mujer a punto de comer pescado .	Una mujer a punto de comer trucha .
Un equipo de atletas jóvenes planea su gran victoria	Su equipo está ganando .
Un cable es más grande que el otro .	Un cable es más grande que el otro .
Un niño tiene un teléfono inteligente y nada más .	Un hombre puede tener un teléfono inteligente .
La gente está al aire libre en una montaña .	La gente está de pie alrededor de dos cuatrimotos en una playa .
Cuatro mujeres están en la piscina .	Las cuatro mujeres están en una piscina
Una niña está intentando esconderse de sus padres	Una muchacha joven tratando de esconderse de su mamá .
Dos hombres están en sus autos en tráfico pesado	Las dos personas están conduciendo camiones .
Dos hombres ubicados en una cabina de control .	Dos hombres de la misma rama militar están sentados en un bus .
El perro negro grande está detrás del perro negro pequeño .	El perro negro y blanco está persiguiendo un gato .
El perro está conduciendo un auto .	El hombre está conduciendo un auto azul .
Esta pequeña niña está emocionada por la boda	La pequeña niña está buscando algo raro .
El hombre viste un polo verde	El hombre viste una camisa de polo verde .
No hay color en la imagen .	Hay un letrero en esta imagen .
Un turista está usando los binoculares para ver el océano .	El perro está a punto de saltar al agua .
Un muchacho joven con un abrigo en su cabeza está sosteniendo su cabra .	Un muchacho joven haciéndose el tonto usa su abrigo en su cabeza y sostiene una cabra .
Una mujer trabaja en una fábrica de quesos .	Un hombre está en la cocina cocinando pan .
El hombre y las mujeres están trotando .	Hay hombres y mujeres caminando .
Un hombre en el interior leyendo el periódico .	Un hombre leyendo el periódico afuera .
Dos hombres se reúnen para almorzar para hablar de negocios .	Tres hombres discuten negocios durante el almuerzo .
Una joven mira hacia otro lado porque es tímida .	Un muchacho joven está a punto de pintar su cara .
Un grupo de cinco corredores se agachó frente a una gran multitud .	Dos hombres frente a una multitud .
El perro está usando un collarín .	El perro está usando un collarín rojo .
Una pareja está disfrutando una connovedora sesión en un sofá .	Una pareja está disfrutando una conmovedora sesión en un sofá viendo una película .
Cuatro personas están saltando en el aire .	La gente está saltando en el aire .
Un animal juega con un aro .	Un hombre africano no está haciendo un truco con un palo .
Los hombres condujeron	Dos hombres sentados cerca de sus bicicletas
Dos bomberos trabajan en el camión de bomberos .	Tres trabajadores están saliendo de su edificio en llamas durante un incendio .
El partido de voleibol está en curso entre las damas	Mujeres participando en las finales de la competencia de tenis
Una mujer con el pelo gris y un vestido blanco de pie delante de una pared .	Un hombre de pie delante de una pared azul con una camisa marrón y pantalones blancos .
En China , los trabajadores en el campo realizan sus tareas mientras se pone el sol .	Trabajadores en China realizan tareas mientras el sol se pone .
Un niño que termina su cono de helado hace una mueca para la cámara .	Una mujer con gafas está leyendo un lado de un tazón de metal
Una multitud está en un evento .	Una carrera se está realizando en un estadio .
Los trabajadores de la construcción están utilizando planos de planta específicos .	Los trabajadores de la construcción están utilizando herramientas para trabajar en el túnel .
Una joven muchacha que sostiene dos bastones para escalar está de pie sobre una roca en un arrollo .	Un hombre y una mujer están escalando en una montaña .
La gente está caminando a través de una estación .	Hay gente caminando en una calle muy concurrida .
Un hombre está en el escenario .	Este hombre está en un escenario
La mujer está cuidando al niño .	Un niño está corriendo hacia su madre .
Hay una persona de pie junto al edificio vistiendo un traje .	Un hombre en un traje negro sentado en los escalones de un edificio .
Un hombre camina en la ciudad .	Una mujer camina en la ciudad .
Un grupo de mujeres en una biblioteca con niños .	Un grupo de niños de la escuela está disfrutando del tiempo de cuentos .
Un jugador de hockey tira el disco .	Un jugador de hockey está jugando con un disco .
Pareja realizando un baile .	Jovencitas se presentan en un recital de baile .
Un excursionista en un sendero mirando la vida animal en una zona boscosa con un canguro negro .	Hombre trotando en un sendero , a través de un gran bosque .
La banda toca para un grupo de personas .	La banda se está presentando para un grupo de personas .
Un niño está en un viaje escolar en un huerto de calabazas .	Una pequeña niña está dibujando en una mesa cerca de un bebé .
La gente está en un partido de fútbol .	Algunas personas están en un partido de fútbol .
Algunos niños están leyendo silenciosamente .	Los niños están leyendo silencionamente .
Un pájaro vuela sobre el lago .	Una persona está caminando hacia el océano .
Los perros corrieron en sentido opuesto .	El hombre y el caballo están huyendo de la policía .
Un hombre monta su biclicleta por la calle .	Un hombre monta su bicicleta por la calle .
La pareja está comiendo .	La familia está comiendo fuera .
El vagón del tren está casi vacío .	Un auto está girando delante del bus que transporta pasajeros .
El perro está tomando un baño .	Un perro está tomando un baño .
Una mujer en una camisa rosada está de pie detrás de una mesa con muchos aderezos para ensaladas y platos de papel .	Una mujer se sienta junto a una mesa cubierta de platos y platillos .
Una persona está sin sombrero y está dentro .	Una mujer está sosteniendo una lata .
Los niños se ríen mientras se deslizan en la nieve .	El gato blanco es difícil de ver en la nieve mientras corre juguetonamente .
Dos hombres arreglan una bicicleta en un garaje .	Dos hombres arreglan un auto en un garaje .
Un caballo y un auto atraviesan el agua .	Un hombre va en bicicleta al agua .
El niño le está diciendo al hombre qué hacer .	La dama no está hablando con nadie .
Una persona está durmiendo en casa .	Una persona está durmiendo en casa .
La mujer está cargando a un niño y posando para una foto .	Un hombre está tomando una foto de una pareja y su hijo .
Un muchacho asiático y un hombre están de pie fuera de Starbucks .	Un niño asiático y una niña asiática están sonriendo en una multitud de personas .
Una multitud se reúne para un discurso importante .	Una audiencia está reunida para una actuación
Niños que giran en una rueda giratoria de cristal	Dos gatos parados en un charco , y uno tiene una pelota de tenis amarilla .
Un hombre envía un pedido de comida	Un hombre de negocios está esperando para pedir comida .
La banda se encuentra bajo los reflectores .	La banda no está en la foto .
La mujer y el hombre están trabajando en una granja .	Un hombre y una mujer están trabajando en un jardín .
El hombre mueve una mesa .	Un hombre guarda una mesa .
Un niño hace una oración ante una vela encendida .	Una anciana está soplando las velas en su torta de cumpleaños de tres niveles .
Dos niños asiáticos lindos y bien vestidos están de pie al lado de un árbol .	Dos niñas pequeñas están felices .
Un niño y un perro en un muelle están viendo otro perro nadar a la lejanía .	Un niño y un perro grande parados en un muelle que mira otro perro nadar en el agua .
Un conductor viste de azul	Una mujer está vistiendo una camisa azul y está montando una bicicleta .
El pequeño niño estaba en el parque .	Un niño estaba saliendo del parque .
Dos niños están en la playa .	Dos niñas están en la playa .
Dos muchachas visitando Nueva York .	Las dos muchachas que trabajan en el restaurante son nuevas .
Dos mujeres sentadas en un banco comiendo .	Cinco mujeres sentadas en un banco .
Fuera de una puerta un par de personas de pie	Dos personas de pie fuera de una puerta .
Tres hombres sacan algo de un tambor .	Dos niños juegan en una llanta columpio grande .
Un bartender está preparando bebidas para sus clientes .	La camarera le está dando a sus clientes bebidas gratis .
Múltiples personas hacen una danza sincronizada con saltos .	Ellos están en un evento de pista .
Los estudiantes están hablando en un debate sobre el control de armas .	Varias personas están haciendo cola en un mostrador .
Un hombre con una barba está pintando .	Un hombre con una barba pintando .
El hombre usa un traje verde	El hombre usa un traje azul .
Estas personas están caminando por un campo de malezas .	Estos dos niños y el perro están corriendo a través de un campo de hierba .
Un muchacho se pone en cuclillas delante de una red vacía con un castillo inflable detrás de él .	Un niño está en cuclillas frente a una red vacía , mientras que otros están de pie alrededor de un castillo inflable detrás de él .
Dos mujeres están sonriendo juntas .	Hay dos mujeres bailando .
Dos niños están en una caja de arena .	Los niños están en una caja de arena .
Un muchacho está montando patineta .	Hay un muchacho montanto patineta afuera .
Una anciana está cosiendo un suéter nuevo en su sala .	Una muchacha es un traje a rayas está de pie en la cocina de su madre , deseando que estuviera en casa .
Todos los niños pasar el rato en la sala de juegos	Algunas personas pasan el rato en el boliche .
Un grupo de niñas están jugando en un basurero .	Un grupo de niños están jugando en el agua .
Hay dos personas , una de ellas un marido y una su esposa , saliendo de la tienda .	Hay dos personas , un hombre y una mujer , sentadas en un bus
Groupe Air France prepara un tren para un viaje	Ellos toman un paseo en el globo de aire caliente sobre el atlántico
Algunos voluntarios ayudan a limpiar al lado de un metro .	Los trabajadores se ofrecen voluntariamente para limpiar el metro .
Una mujer ordeñando una vaca .	Una mujer empuja un carrito .
Un niño pequeño está tomandose de las manos con alguien .	La niña pequeña está tomandose de las manos con alguien .
La niña está caminando a la escuela en la lluvia .	La niña está jugando afuera en la nieve .
La gente de excursión a través de un paisaje helado y montañoso .	La gente está de excursión en una playa .
Gente alta durmiendo	Gente alta caminando
Una mujer está sentada mientras habla con un hombre sin camisa que acaba de conocer	Una mujer está sentada mientras habla con un hombre sin camisa .
Una pelea de hockey estalla .	Una pelea en un juego de hockey estalla
Hay un perro blanco y negro corriendo en un felpudo con un hombre en una camisa azul que mira .	Un perro está parado junto a un hombre en shorts y una camisa azul y blanca .
Hombres que se preparan para tomar un baño en el océano .	Un perro cubierto de nieve hasta su vientre intenta moverse .
Un mujer arrastra un Lobero irlandés	El soldado es una muchacha
La gente está en un bote .	Hay gente en un bote .
Una pequeña niña está jugando fuera .	Una pequeña niña está jugando fuera .
Un niño pequeño se quita toda su ropa .	Una mujer con una camisa azul apretada está de pie como si acabara de soltar algo de su mano .
Dos muchachos que tocan la guitarra con una mujer que canta y que toca una pandereta de pie al lado de ellos .	Dos muchachos que tocan la guitarra con una mujer de pie al lado de ellos .
El snowboarder realiza un truco .	El snowboarder realizó un truco .
Un grupo de personas está sentado en un bar .	Un grupo de personas está de pie en un bar .
Un grupo de varias personas sentadas en el piso dentro de un edificio	Un grupo de personas está sentado en una cornisa delante de un edificio .
Una mujer con los ojos vendados está de rodillas .	Cansada , la mujer descansa su cabeza en su mochila mientras está acostada .
Un hombre en una camiseta juega baloncesto .	Un hombre está en la camiseta deportiva asiste a un juego .
Señores mayores en una chaqueta verde y jeans azules sentados en una pequeña mesa .	Un hombre vistiendo una camisa azul y jeans azules enseñando en una escuela de madera .
Un hombre empujando rocas .	Un mujer está empujando rocas perezosamente .
El niño está usando una chaqueta azul y una camiseta rosada mientras juega afuera .	Un hombre en una camisa naranja y jeans azules está jugando con un hula hula
Un niño con un globo .	El beagle de una mujer tomando un bebida mientras camina
Un hombre joven en una camisa naranja toca la tuba .	Un hombre con una camisa toca los tambores .
Un pintor está pintando un mural al lado de una casa .	Un pintor está pintando una imagen vívida de un parque en el lado de una calle
Seis camiones blancos grandes se están moviendo .	Camiones naranjas grandes están viajando por una calle de cuatro carriles .
El hombre con pantalones amarillos está levantando sus brazos .	El hombre de la camisa amarilla tiene un trapeador en las manos .
Un pequeño niño cayó al suelo .	Una pequeña niña cayendo en la nieve mientras que otra observa .
Una persona del concurso de talentos que salta y canta .	Una audiencia está mirando a una pareja bailar .
Hay un perro marrón saltando en la playa .	Un perro negro y marrón está corriendo en la playa .
Un hombre camina delante de un edificio	Un hombre camina delante de un edificio .
Un hombre está durmiendo afuera .	Una mujer está durmiendo afuera .
Tres personas visten ropa moderna .	Dos personas visten uniformes de trabajo .
Hay un hombre con libros .	Hay un hombre escribiendo .
Asientos amarillos coloridos con una muchedumbre escasa alineada detrás de cuatro jugadores de fútbol que intentan perseguir una pelota .	Dos personas con anteojos están jugando un juego sentadas en el suelo .
Una multitud viendo a un hombre afuera	Una multitud está viendo a un hombre
Una mujer de pie junto a un microondas .	Una mujer al teléfono está sentada en una silla .
Una persona de rojo está saltando en un trampolín .	El hombre está saltando en un trampolín .
Cuatro niños están llorando	Tres niños están llorando
Una niña está cerca de un niño cuyo rostro no se muestra .	Un niño está muy cerca de una niña .
El tren es pequeño	El bote es pequeño .
Un hombre en una piscina sostiene a un niño sonriente en un flotador .	Un hombre está cargando a una niña en una piscina .
Un hombre mayor de beige de pie cerca de un hombre más joven de azul delante de un edificio .	Un hombre en una camisa blanca caminando delante de un edificio antiguo .
Dos mujeres están actuando .	Las dos mujeres están actuando .
Una persona en shorts brillantes trata de atrapar un frisbee	La mujer con la cámara está lanzando un Frisbee para que su perro marrón lo atrape .
El niño rubio se sentó junto a la guitarra y el libro .	La chica estaba jugando con Lincoln Logs .
Dos trabajadores de construcción se detienen en el centro comercial para el almuerzo	Los trabajadores de construcción son detenidos para el almuerzo .
Una pareja pinta en el suelo	Una mujer pinta en el suelo
Gimnasta rítmica hace una rutina .	Una niña realiza una rutina de gimnasia rítmica .
Un trabajador que usa una máscara y que lleva una escoba , de pie vigilando	Un hombre en una camisa azul lleva una bolsa sobre su hombro derecho .
Dos hombres , capas de vestir y bolsas de lona .	Dos niños en jeans azules y camisas de color canela están pie delate de las carpas .
Un ciclista de motocross haciendo una salto cruzado , usando equipo de protección .	Una mujer usando equipo de ciclismo negro y un casco blanco pedalea con fuerza cuesta arriba en su bicicleta .
Un hombre triste está sentado en los escalones de la puerta delante de una casa .	Una mujer está sentada en los escalones de la puerta delante de una casa .
La gente está caminando en una acera de la ciudad .	La gente está caminando por una acera de la ciudad .
