El presidente uruguayo , José Mujica , dio a entender hoy en Brasilia que sigue analizando la venta de su viejo " Fusca " de Volkswagen , después de que un jeque árabe le ofreciera un millón de dólares .	El presidente uruguayo , José Mujica , fue recibido hoy en Brasilia por la jefa de Estado brasileña , Dilma Rousseff , a quien ha querido felicitar personalmente por su reelección en los comicios de octubre pasado .
Reportes de la prensa local y testigos en el noreste de Nigeria sugieren que militantes del grupo islamista Boko Haram han tomado la ciudad de Chibok .	Un grupo de cazadores y vigilantes locales han liberado la importante ciudad de Mubi , en el noreste de Nigeria , que fue tomada por el grupo terrorista Boko Haram hace dos semanas , informaron hoy los medios locales .
Utilizamos las fuerzas policiales , con sus equipos antimotines legales ” , dijo Rangel Ávalos al referirse a la represión de las protestas que comenzaron en febrero de 2014 .	Jens Modvig , relator para Venezuela , inició el 53 ° período de sesiones del organismo haciendo referencia a la represión durante las protestas que comenzaron en febrero de 2014 .
" La situación militar en la zona se ha complicado enormemente en las últimas horas .	Tras una operación organizada el sábado , unas 60 mujeres sufren complicaciones vinculadas a la intervención y 24 de ellas se encuentran en un estado grave , anunciaron las autoridades del Estado de Chhattisgarh ayer .
El incidente aterrador comenzó en el lado sur del edificio , de acuerdo con la CBS de Nueva York .	Todo comenzó en el costado sur del edificio ubicado en el Bajo Manhattan , cuando uno de los cuatro cables que sostienen el aparato se aflojó , dijo el comisionado de bomberos , Daniel Nigro .
El último dirigente de la Unión Soviética , Mijaíl Gorbachov , se reunirá con la canciller alemana Angela Merkel durante los festejos por el 25 aniversario de la caída del Muro de Berlín .	En estas conmemoraciones , Gorbachov prevé reunirse con la canciller alemana Angela Merkel y con el presidente alemán Joachim Gauck .
Se dijo que tras la detención , el capo fue trasladado a las instalaciones de la Subprocuraduría Especializada en Investigación de Delincuencia Organizada , en la ciudad de México .	El hijo de Ismael Mayo Zambada y quien quedó al frente del cártel de Sinaloa tras la detención de Joaquín El Chapo Guzmán , ya se encuentra en la Subprocuraduría Especializada en Investigación de Delincuencia Organizada .
El CEO de Facebook , Mark Zuckerberg se enfrentó por primera vez a un “ interrogatorio ” de sus usuarios este jueves cuando realizó su primera sesión abierta de preguntas y respuestas .	Mark Zuckerberg , el CEO de la compañía , se encargó de responder las preguntas de los propios usuarios de Facebook a través de una sesión de " Preguntas & Respuestas " .
" La última persona que está siendo supervisada en relación con los tres pacientes con ébola en el estado terminará su monitoreo al finalizar el viernes , tras concluir el periodo máximo de 21 días de incubación de la enfermedad " , informó el Departamento de Salud de Texas en un comunicado .	“ Sus ojos estaban muy abiertos , pero no eran sensibles a la luz ” , añadió la médica , quien confesó estar avergonzada por haber expedido el certificado de defunción de una paciente que aún estaba viva .
Sobre los restos que no son de los normalistas , el EAAF explicó que llegaron a dicha conclusión tras recibir los resultados genéticos Laboratorio The Bode Technology Group ubicado en Estados Unidos .	" El EAAF ha obtenido resultados genéticos del Laboratorio The Bode Technology Group ubicado en Estados Unidos , sobre 24 de 30 restos recuperados en Cerro Viejo .
Este es el primer pronunciamiento oficial de este organismo independiente sobre su labor en las investigaciones de la desaparición de los estudiantes de la Escuela Normal Rural de Ayotzinapa el pasado 26 de septiembre .	En un comunicado , los peritos que desarrollan las investigaciones en medio de la búsqueda de los 43 estudiantes de la Normal Rural de Ayotzinapa , desaparecidos hace más de un mes , confirmaron que los restos analizados no pertenecen a los estudiantes y aseguraron que seguirán aportando a la resolución del Caso Ayotzinapa .
Frente al riesgo de que los enfrenamientos se propaguen a las ciudades árabes israelíes , el primer ministro Benjamin Netanyahu amenazó con " retirar la ciudadanía a los que piden la destrucción del estado de Israel " .	Mientras tanto , el primer ministro , Biniamín Netanyahu , expresó que consultará con su ministro del Interior la posibilidad de revocar la ciudadanía a todos aquellos que llaman a la destrucción de Israel .
La llamada Caravana Brigada Nacional de los 43 Desaparecidos recorrerá sietes estados de norte a sur del país , entre ellos Chihuahua , Chiapas , y el propio Guerrero .	Denominan la segunda brigada , como “ Daniel Solís Gallardo ” , recorrerá los estados de Chiapas , Morelos , y Tlaxcala .
Una mujer israelí de 25 años ha muerto esta tarde y otros dos varones han resultado heridos leves al ser apuñalados por un joven palestino a la altura de Alon Shvut , un asentamiento ilegal en el sur de Cisjordania , en la zona de Gush Etzion , el mayor bloque ocupado de la zona .	Una mujer y un militar fallecieron y otras dos personas resultaron heridas en uno de estos ataques , perpetrado al parecer por un palestino que resultó herido de gravedad en el bloque de asentamientos judíos de Gush Etzión , en el territorio ocupado de Cisjordania .
La presidenta ingresó hace una semana a la clínica Otamendi de Buenos Aires con un cuadro febril infeccioso y presencia de bacterias en la sangre .	Kirchner , de 61 años , sufre “ un cuadro de sigmoiditis ” con presencia de bacterias en sangre , según el diagnóstico .
La ONU condena el ataque a una escuela de Nigeria y pide que se haga Justicia Naciones Unidas , 10 nov .	El secretario general de la ONU , Ban Ki-moon , condenó hoy el atentado suicida perpetrado en una escuela en Nigeria , en el que murieron al menos 48 personas , y exigió que se lleve ante la Justicia a los responsables .
Los dos últimos estadounidenses prisioneros en Corea del Norte , liberados gracias a una misión secreta sin precedentes en Pyongyang del jefe de inteligencia estadounidense , llegaron la noche del sábado a Estados Unidos .	" El Departamento de Estado se congratula por la liberación de los ciudadanos estadounidenses Kenneth Bae y Matthew Todd Miller en la República Democrática Pópular de Corea del Norte , donde han estado detenidos durante dos años y siete meses , respectivamente " , dijo en un comunicado el Departamento de Estado , indicó el sábado la AFP .
Moscú El presidente de Perú , Ollanta Humala , se reúne hoy con el jefe del Kremlin , Vladímir Putin , en la primera jornada de su visita a Rusia , la primera de un jefe de Estado de ese país latinoamericano en 45 años de relaciones diplomáticas .	Humala y Putin refuerzan lazos en la primera visita de un presidente de Perú a Rusia Novo-Ogariovo .
El informe de hoy se sustenta en más de 300 entrevistas con hombres , mujeres y niños que han vivido -o todavía están viviendo- en áreas bajo control del Estado Islámico , y de esos testimonios surgen evidencias de abusos que equivalen a crímenes de guerra y contra la humanidad .	Su reporte , basado en más de 300 entrevistas con testigos y víctimas , insta a las potencias mundiales a llevar a los comandantes ante la Corte Penal Internacional por crímenes de guerra y crímenes contra la humanidad .
Kenneth Bae , a la derecha , que estuvo retenido en Corea del Norte en 2012 , habla con la prensa despues de llegar a Estados Unidos el 8 de noviembre de 2014 , en la base militar Lewis-McChord , Washington , EEUU .	Kenneth Bae y Matthew Todd llegaron a la medianoche de sábado para domingo a la base militar Lewis-McChord en la costa del Pacífico del estado de Washington .
Las fuerzas de protección de esa planta han estado recibiendo víveres y munición por vía aérea .	'' Las fuerzas iraquíes fueron capaces de recuperar el control completo de la ciudad de Baiji '' , dijo Ahmed al Krayim , jefe del consejo provincial de Salah ad Din .
Una mezquita cerca de Ramala y una sinagoga en el norte de Israel son las últimas víctimas de la nueva ola de disturbios y ataques .	Una mezquita de Cisjordania y una antigua sinagoga en Israel fueron blanco , la pasada madrugada , de sendos ataques aparentemente cometidos por extremistas en el marco de violencia que sacude la región desde el pasado mes de junio .
El Kremlin defendió hoy la galantería del presidente ruso , Vladímir Putin , que puso sobre los hombros de la primera dama china una manta durante la cena de gala de la cumbre del Foro de Cooperación Económica Asia-Pacífico en Pekín .	La prensa internacional se ha hecho eco este martes de un gesto caballeroso que tuvo el presidente ruso , Vladímir Putin , durante la cena de gala celebrada con motivo de la cumbre de la APEC en Pekín , informa el periódico ruso ' Vzgliad ' .
" El Consejo General de la OMC va a recibir la propuesta de la India y Estados Unidos la apoyará " , destacó la ministra india .	India presentará su propuesta ante el Consejo General de la OMC en su reunión de diciembre .
El grupo extremista ataca a grupos étnicos , periodistas , mujeres y niños , señala el documento .	  “ Los padres de niñas y mujeres solteras temen que sus hijas sean forzadas a casarse con combatientes de ISIS y como resultado el matrimonio infantil está al alza .
El líder del equipo de Enfermedades Zoonóticas Emergentes y Epidémicas de la OMS , Pierre Formenty , ha explicado que se han realizado grandes esfuerzos para que los entierros sean seguros .	Lo confirmó hoy el jefe del equipo de zoonosis emergentes y epidémicas de la Organización Mundial de la Salud , Pierre Formenty , en la presentación de un nuevo protocolo sobre funerales seguros y dignos de fallecidos por el ébola .
La cuenta de la Presidente en Twitter , que permanecía inactiva desde que la mandataria debió ser internada en el Sanatorio Otamendi , se reactivó este miércoles con la reproducción del comunicado de Cancillería sobre el retiro de la candidatura de la embajadora Susana Ruiz Cerutti para integrar la Corte Internacional de Justicia de La Haya .	Además , la mandataria difundió a través de la web la decisión de la Argentina de retirar la candidatura de la embajadora Susana Ruiz Cerrutti para integrar la Corte Internacional de Justicia , y evitar así un escenario de competencia con el postulante jamaiquino y “ priorizar el fortalecimiento de la unidad regional ” .
Según un comunicado de la Fiscalía colombiana , contra Orellana " pesaba orden de captura en circular roja por cargos de asociación ilícita y lavado de activos " .	Las autoridades colombianas capturaron este jueves en Cali al empresario peruano Rodolfo Orellana , prófugo en su país , contra quien existía una circular roja por asociación ilícita y lavado de activos , informó este jueves la Fiscalía .
Los forenses se encargan de la recuperación , el análisis y la eventual identificación de los cuerpos .	La búsqueda de los restos humanos se realiza a través de testimonios de la gente y de los conocimientos de la arqueología forense .
Según explicó , Sierra Leona contabiliza 80 infecciones diarias , una cifra que en diez días desbordará las 800 camas libres que hay en los hospitales .	Según precisó , l'últimu informe que recibió de Sierra Lleona contabiliza unes 80 infecciones diaries , una cifra qu'en diez díes va enllenar les 800 cames llibres qu'hai nos hospitales .
Hagel remarcó la necesidad de " incrementar nuestro personal nuclear " y hacer frente " a la sensación generalizada de que una carrera en el programa nuclear ofrece pocas oportunidades para crecer y progresar " , al comentar la " baja moral " existente quienes trabajan en esta materia .	" La raíz del problema ha sido la falta de concentración , atención y recursos , lo que crea la sensación generalizada de que la carrera nuclear ofrece escasas oportunidades de desarrollo y avance " .
La presidenta argentina Cristina Fernández fue dada de alta el domingo , tras permanecer siete días internada en una clínica privada de Buenos Aires debido a un cuadro de infección intestinal .	La presidenta argentina , Cristina Fernández , recibió hoy el alta médica tras permanecer una semana internada por un cuadro de sigmoiditis y se dirigió a la residencia oficial , donde deberá guardar reposo por otros diez días .
Los marinos capturaron a Ismael Zambada Imperial , ' El Mayito Gordo ' , hijo del capo sinaloense , y a otras cinco personas , de acuerdo con reportes preliminares .	‎Hace 8 horas‎ Ismael Zambada Imperial , " El Mayito Gordo " , declara en la Seido luego de que fue ubicado en Culiacán con cinco presuntos cómplices , entre ellos un primo .
Malí registró su primer caso con la muerte de una niña de dos años el 24 de octubre en Kayes , que viajó con su abuela desde el sur de la vecina Guinea , donde se declaró la epidemia en diciembre de 2013 .	La víctima , una niña de Guinea de dos años que viajaba con su abuela , fue diagnosticada con el ébola cuando estaba en Kayes , en el oeste de Malí , donde murió el 24 de octubre .
Recientemente , el embajador de México en Uruguay le dijo a Mujica que podría conseguir hasta cuatro camionetas a cambio del mítico vehículo , según recoge el diario The Guardian .	La segunda oferta la recibió Mujica del embajador de México en Uruguay , Felipe Enríquez , quien le ofreció diez camionetas a cambio del Fusca celeste .
El magma comenzó a fluir en junio y entró a Pahoa , el poblado más grande de la Gran Isla y al distrito agrícola de Puna , el 26 de octubre .	Medios locales aseguraron que el volcán Kilauea inició a expulsar lava en junio pasado , la cual arribó al distrito Pahoa hasta el 26 de octubre .
Ese personal militar no tendrá un papel de combate , sino que su misión será entrenar , asesorar y ayudar a las Fuerzas de Seguridad iraquíes , incluidas las tropas kurdas .	Estas tropas no combatirán en el terreno y servirán “ para entrenar , aconsejar y asistir las fuerzas de seguridad iraquíes , incluyendo las fuerzas kurdas ” , añadió .
La operación de detención tenía como objetivo a Ismael Zambada padre , y fue realizada en el poblado conocido como El Salado , en el municipio de Culiacán , Sinaloa .	De acuerdo con el sitio web RíoDoce , “ El Mayito Gordo ” fue detenido por elementos especiales del Ejército Mexicano en el poblado La Estancia de los Burgos , perteneciente a la sindicatura de El Salado , municipio de Culiacán .
El director general de la ESA , Jean-Jacques Dordain , calificó el aterrizaje de Philae sobre el cometa 67 / P Churyumov-Gerasimenko como " un gran paso para la civilización humana " .	La ESA y sus socios de la misión Rosetta han logrado algo extraordinario hoy " , ha dicho el director general de la ESA , Jean-Jacques Dordain , quien cree que la se ha " asegurado un lugar en los libros de historia " por ser los primeros en orbitar un cometa y aterrizar sobre él .
La policía de Gales del Sur , irrumpió en la habitación de un hotel cuando Matthew Williams le estaba comiendo la cara a una mujer .	El staff de seguridad del hotel irrumpió en la habitación cuando este no los dejó entrar .
Un hombre vestido como un estudiante detonó la bomba cuando los escolares se encontraban reunidos en una asamblea antes de empezar las clases en un colegio de Potiskum , capital de la provincia de Yobe , donde actúa el grupo terrorista Boko Haram .	La tragedia podía haber sido mayor , ya que en el momento de la explosión , alrededor de las 8:00 de la mañana , hora local , estaban reunidos unos 2.000 estudiantes en una asamblea antes de empezar las clases en un colegio de Potiskum , cercano a Damaturu , capital de Yobe .
" Escocia será una nación independiente , ahora lo sabemos con más certeza que antes " , afirmó Salmond durante el congreso anual de su partido que se celebra en Perth , dos meses después del referéndum en el que un 55% de los escoceses rechazaron la secesión .	El político nacionalista , que anunció su dimisión el 19 de septiembre , un día después de esa consulta , cederá también el cargo de ministro principal escocés que ocupa desde 2007 la próxima semana , cuando el Parlamento de Edimburgo confirmará a su " número dos " , Nicola Sturgeon , como nueva jefa del gobierno autónomo .
Sin embargo , las autoridades esperan que las autopsias detallen con precisión la causa de las muertes .	Las autoridades afirman que desconocen las causas de las muertes y que sólo las autopsias determinarán lo ocurrido .
El convenio se suma al acuerdo alcanzado en mayo para que la estatal rusa Gazprom provea 38.000 millones de metros cúbicos de gas al año a China usando los depósitos en Siberia Oriental .	" La ruta occidental prevé el suministro de gas a China desde los yacimientos de gas en Siberia occidental .
Igual de risueño , Amr paseaba con orgullo por la Mukata , a los pies del mausoleo , una bandera de Suecia , que destacaba entre los cientos de blasones de Al Fatah , escudos de la Organización para la Liberación de Palestina y enseñas nacionales palestinas .	" Nos han privado de este aniversario , pero la historia no perdonará a los que frenan el plan de Abu Amar para la liberación de Palestina " .
La iglesia mormona ha reconocido por primera vez en su historia que su fundador , Joseph Smith , tuvo entre 30 y 40 esposas .	Ahora , la Iglesia dice que tras “ estimaciones cuidadosas ese número se sitúa entre treinta y cuarenta″.
La delegación del Estado , encabezada por el viceministro de Política Interior y Seguridad Jurídica , José Vicente Rangel Ávalos , no respondió con precisión las preguntas hechas por los relatores y expertos del Comité .	El viceministro de Política Interior y Seguridad Jurídica , José Vicente Rangel Ávalos , señaló que antes de que el pueblo eligiera al presidente Hugo Chávez , “ La tortura estaba institucionalizada y el asesinato político era frecuente ” en Venezuela .
En más de un mes de investigación el EAAF ha intervenido en exhumaciones de dos de treinta restos recuperados en Cerro Viejo y en la recuperación de uno de los nueve restos hallados por las autoridades mexicanas en la localidad de La Parota / Cerro de Lomas de Zapatero .	Además , el EAAF ha sido autorizado por PGR para trabajar en el examen forense de la totalidad de los restos recuperados en dicho sitio .
En el caso de la joven de 14 años , Helen Mar Kimball , hija de un amigo cercano de Joseph Smith , el matrimonio fue solo para la eternidad con lo que , según dice el ensayo , que apunta que en esa época era legal casarse con chicas de esa edad , no habría implicado relaciones sexuales .	La Municipalidad de Montevrain colocó un aviso en su página de Facebook avisando que un tigre joven fue detectado en los arbustos detrás de unas canchas de tenis y de fútbol a menos de nueve kilómetros de EuroDisney .
Si es aprobada por el Senado , Lynch sería la segunda mujer en ser la fiscal general del país y la primera mujer afroamericana en el cargo .	El Parlamento de Holyrood designará el miércoles a Sturgeon como la primera mujer jefa del Gobierno autónomo y está previsto que jure el cargo el próximo jueves .
El presidente peruano ha llegado a Moscú en una visita histórica , la primera en 45 años de relaciones diplomáticas .	Se trata de la primera visita de un presidente de Perú a Rusia en los 45 años de relaciones diplomáticas , por lo que ha sido calificada de " histórica " por ambas partes .
Perú también tiene interés en firmar a futuro un Tratado de Libre Comercio con la Unión Económica Euroasiática , alianza que engloba a Rusia , Bielorrusia y Kazajistán y que entrará en vigor el 1 de enero de 2015 .	Humala asistió a firma de varios convenios entre nuestro país y Rusia .
Humala , el primer mandatario peruano en visitar Rusia en 45 años de relaciones diplomáticas , será recibido por Putin en la residencia campestre del jefe del Kremlin en Novo-Ogariovo , a las afueras de Moscú .	Al principio de la reunión y en presencia de las cámaras , Putin dio la bienvenida a Humala , el primer mandatario de nuestro país en visitar Rusia en 45 años de relaciones diplomáticas .
El ministro de Transportes Andrés Gómez-Lobo anunció que Transantiago sumó 150 buses a su flota para enfrentar los problemas ocurridos que provocó la grave falla eléctrica en la red de Metro , que afectó a tres de sus líneas .	Carabineros también tuvo que reforzar su fuerza para contener los problemas que se pudieran suscitar a raíz de la molesta falla en el metro .
La reforma migratoria afecta desproporcionadamente a los latinos en el país . Alrededor de 60 porciento de los 11 millones indocumentados en EE.UU. vienen de un país—México .	" Según los expertos , eran 9 de los 11 millones de indocumentados que viven en Estados Unidos .
En ellas , los pacientes suelen ver objetos , animales y hasta gente que en realidad no existe al grado de conversar constantemente con los productos de su mente .	Las alucinaciones son comunes en los pacientes : pueden ver objetos moviéndose , o personas y animales que no existen .
El robot Philae de la sonda espacial europea Rosetta se posó hoy sobre un cometa a más de 510 millones de kilómetros de la Tierra , un hito sin precedentes en la historia de la conquista espacial .	El cometa Chury se encuentra actualmente viajando entre las órbitas de Júpiter y de Marte , a más de 450 millones de kilómetros de la Tierra .
Zarif y su equipo iniciarán mañana dos días de negociaciones con el secretario de Estado norteamericano , John Kerry , y la coordinadora por parte de la Unión Europea y ex jefa de la diplomacia de la UE , Catherine Ashton .	Mohammad Javad Zarif sostendrá conversaciones con el secretario de Estado de Estados Unidos , John Kerry , y con la enviada de la Unión Europea , Catherine Ashton , en Omán el domingo para tratar de salvar brechas antes de que se reanuden las negociaciones en Viena el 18 de noviembre .
La captura fue encabezada por Marita Barreto , la fiscal peruana que estaba a cargo del caso y que había tramitado ante Interpol la captura internacional de Orellana Rengifo .	Según indicó , la captura fue pasada la medianoche y ya se verificó que sí se trata de Orellana .
La APEC responde por el 40% de la población mundial , casi la mitad del comercio y más de la mitad del PIB del planeta .	Entre sus 21 países miembros , donde destacan Estados Unidos , Rusia , China y Japón , suman más de la mitad del PIB global , el 44 por ciento del comercio mundial y el 40 por ciento de la población del planeta .
Fernández de Kirchner mantuvo varias reuniones el martes , entre ellas una con los ministros de Economía , Axel Kicillof ; y de Relaciones Exteriores , Héctor Timerman , quienes representarán a la Argentina en la Cumbre del G20 que se celebrará a partir de mañana en Australia .	El jefe de Gabinete subrayó que “ una de las reuniones más trascendente ” de la jefa de Estado fue con el ministro de Economía , Axel Kicillof , y el canciller Héctor Timerman , “ sobre la base de la representación que tendrá nuestro país en la reunión del G-20 en Australia ” .
Por otra parte , el líder peruano dijo en Moscú que su país tiene interés en “ conocer más el funcionamiento de la Unión Euroasiática ” porque siendo Perú miembro de la Alianza del Pacífico , se puede “ intercambiar experiencias ” y empezar a elaborar un memorándum que permita acercarse “ paulatinamente ” al bloque formado por Rusia y otros países exsoviéticos .	El presidente de Perú también afirmó que su país está interesado en conocer más a fondo la Unión Aduanera , que un espacio de l , ibre comercio que forman Rusia , Kazajistán y Bielorrusia .
En cuanto a los once tripulantes restantes que estaban en el banquillo , todos recibieron penas de entre cinco y diez años de cárcel , precisó la agencia EFE .	Tribunal ha puesto penas de entre 30 y cinco años de cárcel a otros 14 miembros de la tripulación .
Una polaca de 91 años , declarada muerta en su casa por una médica y trasladada a la morgue , se despertó 11 horas después , informó este jueves un canal de televisión estatal .	Revive una mujer de 91 años 11 horas después de ser declarada muerta y pide dos crepes .
" Eso significa que si las empresas comparten contenido que les puede ser útil a ellos entonces mostraremos eso .	Pero si por el contrario las empresas comparten contenido que no les interesa , no lo mostraremos , ya que probablemente sea más importante que se enteren de que el bebé de un amigo está sano " .
El Papa Francisco mantuvo hoy una audiencia privada con el presidente Ollanta Humala , en el Vaticano .	El papa Francisco intercambia regalos con el presidente de Perú Ollanta Humala y su esposa Nadine Heredia .
Purguín aseguró que el régimen de alto el fuego no se respeta en el 75 por ciento de la virtual línea de separación entre ambos bandos .	Coincidiendo con la reanudación de los combates en torno a Donetsk , los separatistas han anunciado que propondrán la revisión de los acuerdos de Minsk , que incluyen una declaración de alto el fuego y una línea de separación entre ambos bandos en conflicto .
Igual de risueño , Amr paseaba con orgullo por la Mukata , a los pies del mausoleo , una bandera de Suecia , que destacaba entre los cientos de blasones de Al Fatah , escudos de la Organización para la Liberación de Palestina y enseñas nacionales palestinas .	" Nos han privado de este aniversario , pero la historia no perdonará a los que frenan el plan de Abu Amar para la liberación de Palestina " .
En un verdadero encuentro récord , el turco Sultan Kösen , el hombre más alto del mundo y el nepalí Chandra Dangi , el más pequeño se reunieron en Londres , justamente para celebrar el 60 ° aniversario del libro de los récords Guiness .	La reunión entre el gigantesco turco Sultan Kösen y el diminuto nepalí Chandra Bahadur Dangi fue organizada por el libro Guinness de los récords y tuvo lugar en un jardín del centro de Londres .
El presidente de Estados Unidos , Barack Obama , autorizó el despliegue de hasta 1.500 efectivos militares adicionales en Irak para entrenar y asesorar a sus fuerzas y a los combatientes kurdos en su lucha contra Estado Islámico .	Por su parte , el presidente de Estados Unidos , Barack Obama , considera que su decisión de duplicar en número de tropas en suelo iraquí en labores de asesoramiento y entrenamiento marca " una nueva fase " en la lucha contra el grupo yihadista Estado Islámico , según aseguró en una entrevista emitida en la cadena CBS , destacó Efe .
La operación de detención tenía como objetivo a Ismael Zambada padre , y fue realizada en el poblado conocido como El Salado , en el municipio de Culiacán , Sinaloa .	El hijo del capo , Ismael Zambada Imperial , " El Mayito Gordo " , fue presuntamente aprehendido este miércoles en el poblado La Estancia de los Burgos , perteneciente a la sindicatura de El Salado , municipio de Culiacán .
El jefe de ministros calificó como " muy trascendente " que la mandataria haya retomado la agenda gubernamental , pero recordó debe guardar reposo hasta el próximo miércoles .	Así lo informó el jefe de Gabinete , Jorge Capitanich , durante su habitual conferencia de prensa , donde indicó que la Jefa de Estado " ha retomado de una manera incipiente la agenda gubernamental " , pero aclaró que lo hizo " en el marco de la prescripción médica que tiene la presidenta " .
En entrevista para la cadena de noticias CNN , Robert O’Neill , quien fue miembro del grupo élite de fuerzas especiales Navy Seal de Estados Unidos durante 15 años , afirmó que el ex líder de Al Qaeda , Osama Bin Laden , “ murió asustado como una gallina ” .	En unas declaraciones brindadas por O'Neill para la cadena CNN , el marine reveló que Bin Laden estaba muy asustado cuando lo encontraron .
El protocolo de Minsk fue firmado por los representantes de Ucrania , Rusia , y las autoproclamadas repúblicas populares de Donetsk y Lugansk bajo los auspicios de la OSCE .	" Cualquier intento de arreglar el conflicto sin la participación de las repúblicas populares de Donetsk y Lugansk será inútil y llevará inexorablemente el proceso negociador a un callejón sin salida " , dijo Denís Pushilin , negociador de la autoproclamada república popular de Donetsk .
El presidente avanzó el miércoles que pedirá a las cámaras una autorización concreta para la ofensiva militar contra el EI , algo que en septiembre no consideraba necesario .	El presidente Barack Obama le pidió al Congreso el miércoles que trabaje con él en una nueva autorización que reemplace aquella creada tras los ataques terroristas del 11 de septiembre del 2001 y permita usar la fuerza militar contra el grupo extremista Estado Islámico .
El andamio es inestable , los empleados están suspendidos en el piso 69 y se observa que cuelgan en un ángulo inestable , de acuerdo a las imágenes que surgieron de la escena .	Los trabajadores están colgando en un ángulo de 65 grados , de acuerdo con la policía de Nueva York .
En términos generales el libro combina un recuento bien hecho de la historia del narcotráfico en Colombia con el drama de la familia que la protagonizó .	El libro no solo es un recuento de la historia de mi padre y de los hechos en los que él tuvo alguna participación , es también mi historia , mi experiencia que la quiero transmitir a los jóvenes para que puedan aprender que esa historia nadie debe repetirla .
Orellana estaba prófugo en Perú desde hace más de 130 días y , además de afrontar los cargos se le imputan , es investigado en su país por presuntos nexos con el narcotráfico .	Rodolfo Orellana está acusado de blanqueo de dinero y asociación para delinquir , además de ser investigado por narcotráfico .
La primera ministra de Perú , Ana Jara , señaló el jueves , en un mensaje en la red social Twitter , que el empresario y abogado peruano sería expulsado hoy desde Colombia a Perú , para lo cual viajarían Urresti y un equipo de la Policía Nacional .	La jefa del Gabinete señaló , en un mensaje en la red social de Twitter , que " hechos los trámites con Colombia , ministro Daniel Urresti y equipo PNP viajarán allá , a traer al prófugo Orellana , que en la mañana será expulsado " .
La sobrina de la anciana y también su cuidadora , Bogumila Kolkiewicz , explicó hoy a la cadena de televisión TVP que afortunadamente su tía no tiene ningún recuerdo de lo sucedido .	Fuentes de su familia explicaron que la señora sufre de demencia y que aparentemente no está consciente de lo cerca que estuvo de la muerte .
Las manifestaciones y protestas se sucedieron hoy intermitentemente en todo Israel , en centros universitarios , cruces de carreteras y poblados árabes , extendiéndose por la tarde a decenas de poblados .	Las concentraciones se sucedieron en Reine , Kfar Kana , Shaab , Kfar Kasem , así como en cruces neurálgicos de la Galilea .
También un volumen y una imagen del " Señor de los Milagros " , porque " el fervor religioso paraliza Lima " y una camiseta de la selección peruana " para que les ayude con el padre Celestial para que Perú vuelva a estar en el Mundial " , según Humala .	El jefe de Estado peruano le regaló al Pontífice una serie de presentes representativos de nuestro país , como un libro de recetas con quinua , un volumen y una imagen del Señor de los Milagros , una camiseta de la selección peruana , y una bufanda “ para que la use cuando tenga frío ” , dijo Humala .
La policía arresta a activistas de la organización feminista Femen durante una protesta convocada en la Plaza de San Pedro del Vaticano .	Tres miembros del grupo feminista de Femen realizaron este viernes actos obscenos con crucifijos en la Plaza de San Pedro , en el Vaticano , para protestar contra el viaje del Papa Francisco al Parlamento Europeo el 25 de noviembre .
Las más de 30.000 entrevistas personales se realizaron en todos los países latinoamericanos hispanoparlantes menos Cuba .	El informe está basado en más de 30.000 entrevistas personales realizadas entre octubre de 2013 y febrero de 2014 , en 18 países de América Latina y Puerto Rico .
Armados con bates de madera , machetes , arcos , flechas y armas de fuego artesanales para caza , un grupo de estos Vigilantes logró liberar este miércoles la ciudad de Maiha , que estaba bajo control de los salafistas .	Sin embargo , en un esfuerzo por ser transparente sobre los aspectos más polémicos de su historia , la iglesia finalmente reveló la verdad sobre los matrimonios de su fundador en su portal oficial .
“ Loretta podría ser la única abogada en Estados Unidos que lucha contra mafiosos , narcos y terroristas y aún conserva la reputación de ser una persona encantadora ” , dijo Obama al presentarla en la Casa Blanca .	“ Loretta puede ser la única abogada en Estados Unidos que combate criminales , narcotraficantes y terroristas , y además tiene la reputación de ser una persona encantadora ” , señaló Obama al hacer el anuncio en el salón Roosevelt de la Casa Blanca .
El presidente Juan Manuel Santos aseguró que habló del caso con su homólogo peruano , Ollanta Humala e informó que " entre hoy o mañana será entregado este individuo a las autoridades peruanas " .	El presidente de Colombia , Juan Manuel Santos , había indicado más temprano que Rodolfo Orellana sería entregado a las autoridades peruanas " entre hoy y mañana " .
De igual forma los alumnos de la escuela rural anunciaron su participación en la caravana nacional de protesta y para informar a la población sobre la situación actual en el estado de Guerrero .	Es el principal argumento de los padres de los estudiantes de la Normal Rural de Ayotzinapa desaparecidos en Iguala el 26 de septiembre -a los que la Procuraduría General de la República da por muertos « con toda probabilidad»- , para iniciar la caravana nacional de protesta que ya anunciaron en su última manifestación en el Distrito Federal , el pasado 5 de noviembre .
La comisión de urbanismo de Jerusalén ha aprobado este miércoles la construcción de 200 nuevas viviendas en el barrio de Ramot , en Jerusalén Este , en plena escalada de tensiones en la zona por los últimos ataques violentos en ciudades israelíes y Cisjordania .	Las autoridades israelíes aprobaron preliminarmente el miércoles la construcción de 200 viviendas en un área judía en Jerusalén oriental , en una medida que casi seguramente incrementará tensiones en la ciudad .
La primera aparición pública se produjo pero , este miércoles por la noche a través de Twitter cuando la presidenta anunció que Argentina retiraba la candidatura de la embajadora Susana Ruiz Cerutti del Tribunal Internacional de Justicia .	Además , la mandataria difundió a través de la web la decisión de la Argentina de retirar la candidatura de la embajadora Susana Ruiz Cerrutti para integrar la Corte Internacional de Justicia , y evitar así un escenario de competencia con el postulante jamaiquino y “ priorizar el fortalecimiento de la unidad regional ” .
La mandataria se reunió con funcionarios nacionales , entre ellos el ministro de Economía , Axel Kicillof , y repasó el nivel de volumen de reservas monetarias , de depósitos bancarios y de la recaudación fiscal , se indicó .	Capitanich reseñó que la jefa de Estado estuvo reunida ayer con otros funcionarios de distintas áreas y que se efectuó un monitoreo del volumen de reservas , del volumen de depósitos , de la recaudación fiscal , y una supervisión de las variables macroeconómicas .
Un grupo de científicos del instituto japonés de Riken ha creado un ratón adulto transparente , lo que puede permitir estudiar la evolución de las enfermedades como el cáncer o la diabetes en sus órganos , sin la necesidad de diseccionar al roedor .	Un equipo de investigadores de la Universidad de Tokio y el Instituto de Investigación Riken , Japón , desarrolló una raza de ratones transparentes , esto con el objetivo de observar sus órganos y estudiar la evolución de enfermedades como el cáncer o la diabetes sin tener que hacer disecciones .
El precio posteriormente será de 9,99 dólares mensuales , abono que también permitirá el acceso al servicio de música " streaming " de Google , con más de 30 millones de canciones .	Los suscriptores de Music Key tendrán acceso gratuito al " streaming " de las 30 millones de canciones presentes en la tienda Google Play .
El frente del río incandescente se detuvo el 30 de octubre y permaneció a unos 150 metros de la carretera principal de Pahoa Village .	La punta del flujo de lava principal permanece detenida a unos 150 metros de la calle Pahoa Village , que lleva a la zona donde residen la mayor cantidad de personas del pueblo , de unas 1.000 personas .
El equipo , compuesto por investigadores de la Universidad de Tokio y del prestigioso instituto de investigación Riken , logró tornar los ratones transparentes tras administrarles un compuesto químico .	La investigación , llevada a cabo por científicos de la Universidad de Tokio y del instituto Riken , se realizó a través de un cóctel de sustancias químicas , conocido en el sector como CUBIC , que decolora la sangre y permite la invisibilidad de la capa exterior .
Obama autorizó al secretario de Defensa , Chuck Hagel , para el despliegue en Irak de cerca de 1.500 elementos adicionales en los próximos meses para un papel ajeno al combate con el fin de ampliar la misión de asesoría y asistencia de Estados Unidos y de iniciar un esfuerzo de entrenamiento integral para las fuerzas iraquíes , dijo el secretario de Prensa del Pentágono , John Kirby .	El presidente Barack Obama autorizó el despliegue de otros 1.500 soldados estadounidenses a Irak en los próximos meses , informó el Departamento de Defensa el 7 de noviembre .
En el documento se agregó que hoy el EAAF solicitó a la PGR copia de los dictámenes en genética forense de exclusión identificatoria entre los restos recuperados en Pueblo Viejo y los familiares de los 43 jóvenes desaparecidos de Ayotzinapa .	Además , el EAAF ha sido autorizado por PGR para trabajar en el examen forense de la totalidad de los restos recuperados en dicho sitio .
La situación seguía siendo tensa hoy en la zona en conflicto en el este de Ucrania .	Según informó el gobierno alemán en un comunicado , Merkel expresó a Poroshenko su “ profunda preocupación ” por la información que apunta a “ nuevos movimientos de tropas rusas ” en el este de Ucrania .
La matanza se produce una semana después de que un ataque suicida similar segara la vida de veinte personas en la escuela islámica Faydia de Potiskum , que pertenece a un grupo de la rama chiíta del islam .	La explosión ha tenido lugar en una escuela de la localidad de Potiskum , en la región de Yobe .
Obama dijo que espera que el Senado confirme sin retraso a la fiscal federal de Brooklyn quien , dijo , se ha distinguido por ser " dura y justa " .	Obama ha expresado sus esperanzas de que el Senado ratifique rápidamente el nombramiento de una mujer " dura y justa " .
El capitán del buque surcoreano Sewol , cuyo naufragio causó 304 muertos , evitó la pena de muerte al ser condenado hoy a 36 años de cárcel como máximo responsable de la tragedia , mientras las autoridades dieron por concluidos los trabajos de rescate del barco , aunque todavía hay nueve desaparecidos .	La sentencia del alto tribunal comunitario , con sede en Luxemburgo , señala que los ciudadanos comunitarios que no ejerzan una actividad económica y que se trasladen a otro Estado miembro con el único objetivo de obtener una ayuda social , " pueden ser excluidos de la percepción de determinadas prestaciones sociales " .
Al parecer , el Gobierno de Estados Unidos le niega a O’Neill la pensión compensatoria por sus 16 años de servicio al no cumplir con los 20 mínimos que estipula la ley para poder acceder a la pensión económica .	Ahora , retirado de la vida militar el gobierno de EEUU le niega la veteranía por no cumplir con al menos 20 años de servicio militar .
En el ataque , perpetrado este lunes , al menos 48 personas -en su mayoría estudiantes- murieron y otras 79 resultaron heridas en una escuela de secundaria en la localidad de Potiskum , en el noreste de Nigeria .	El ataque suicida provocó el caos , obligando a cerrar la mayoría de escuelas de la localidad de Potiskum .
Funcionarios de Departamento de Justicia no confirmaron ni negaron la existencia de tal programa , aunque dijeron que éste cumplía con la ley , lo que incluía obtener permiso de un juez para realizar tales operaciones .	El Departamento de Justicia no confirmó ni negó al periódico la existencia de tal programa , alegando que hablar de tales asuntos permitiría a presuntos criminales de potencias extranjeras determinar las capacidades de vigilancia de EU , y agregó que las agencias del Departamento de Justicia acatan la ley federal , incluyendo solicitar aprobación de la corte .
El presidente de Estados Unidos , Barack Obama , tiene previsto designar a la abogada afroestadunidense de Nueva York , Loretta Lynch , como procuradora de Justicia en sustitución de Eric Holder , reportó hoy la cadena CNN .	El presidente de Estados Unidos , Barack Obama , nominó hoy a la fiscal federal Loretta Lynch para reemplazar a Eric Holder como la próxima fiscal general del país .
Bajo un arreglo , Jordania tiene derechos de custodia sobre sitios sagrados musulmanes en Jerusalén , incluyendo el complejo conocido por los judíos como el Monte del Templo y por los musulmanes como el Noble Santuario .	Las visitas de los fieles judíos al sitio — conocido por los judíos como Monte del Templo y por los musulmanes como Explanada de las Mezquitas — han generado preocupación entre los musulmanes sobre que Israel pueda estar intentando hacerse con el control del lugar en secreto .
El último dirigente de la Unión Soviética , Mijaíl Gorbachov , se reunirá con la canciller alemana Angela Merkel durante los festejos por el 25 aniversario de la caída del Muro de Berlín .	En declaraciones para la agencia Interfax , Mijaíl Gorbachov aseguró que defenderá a Vladimir Putin en la conmemoración del 25 aniversario de la caída del Muro de Berlín , al afirmar que el líder del Kremlin “ defiende mejor que nadie los intereses de Rusia " .
El presidente de Estados Unidos , Barack Obama , anunciará a comienzos de la próxima semana un plan para modernizar la política de inmigración del país norteamericano mediante una acción ejecutiva , que incluiría la suspensión de las deportaciones de millones de inmigrantes indocumentados , según informa Fox News .	Obama anunciará un paquete de medidas migratorias la próxima semana según la cadena FOX
La Iglesia de Jesucristo de los Santos de los Últimos Días ha intentado encubrir aspectos de su historia , como la poligamia practicada por Smith y Brigham Young , quien colaboró en la fundación de la ciudad Salt Lake City , en Utah , donde se encuentra la sede central de la institución .	La Iglesia de Jesucristo de los Santos de los Últimos Días , que oficialmente desaprobó la poligamia a finales del siglo XIX , había intentado por años mostrar a Smith como un leal esposo a su mujer Emma .
Gracias a esta colaboración ha sido posible echar el cierre a la carretera de la seda , es decir , cerrar Silk Road 2.0 , y detener a la cabeza pensante , Black Benthall .	Gracias a esa iniciativa de las fueras y cuerpos de seguridad se lograba cerrar Silk Road 2.0 y arrestar a su responsable , Blake Benthall .
Lee admitió en el juicio que el pánico le paralizó y que no pudo tomar las " medidas adecuadas " para tratar de salvar a los pasajeros .	El juez expuso en su sentencia que el capitán fue el máximo responsable del trágico final del naufragio , ya que retrasó la orden de evacuación , no tomó las medidas oportunas cuando el barco comezó a hundirse y posteriormente no realizó esfuerzos para rescatar a los pasajeros .
Uno de cada 10 latinoamericanos se criaron en el protestantismo , pero uno de cada cinco se dicen protestantes .	En ese cuadro , " aproximadamente uno de cada cuatro nicaragüenses , uno de cada cinco brasileños y uno de cada siete venezolanos se declaran como excatólicos " .
Esta vez , el examen reveló que el artista padecía de demencia de cuerpos de Lewy y que , además , no se había intoxicado al momento de su suicidio , en agosto de este año .	La demencia de cuerpos de Lewy se produce debido a la acumulación anormal de proteínas en el cerebro .
Los trabajos de rescate , en los que han participado miles de buzos , comenzaron inmediatamente después de que se hundiera el barco el 16 de abril con 476 personas a bordo , la mayoría estudiantes de un instituto de bachillerato de Ansan , al sur de Seúl .	El ferry Sewol se hundió el 16 de abril mientras viajaba de Incheo a la isla de Jeju , al suroeste de la península coreana .
Los dos últimos estadounidenses prisioneros en Corea del Norte , liberados gracias a una misión secreta sin precedentes en Pyongyang del jefe de inteligencia estadounidense , llegaron la noche del sábado a Estados Unidos .	" El Departamento de Estado se congratula por la liberación de los ciudadanos estadounidenses Kenneth Bae y Matthew Todd Miller en la República Democrática Pópular de Corea del Norte , donde han estado detenidos durante dos años y siete meses , respectivamente " , dijo en un comunicado el Departamento de Estado , indicó el sábado la AFP .
El proyecto prevé ampliar el programa de acción diferida para los indocumentados que llegaron a Estados Unidos siendo niños , a fin de incluir a los padres de ciudadanos estadunidenses y residentes legales permanentes , lo que podría beneficiar a 4.5 millones de personas .	El presidente evalúa , además , ampliar las protecciones que ya existen para los jóvenes indocumentados que llegaron a EE.UU. cuando eran niños y extenderlas también a sus padres , lo que beneficiaría a más de un millón de inmigrantes .
El Papa Francisco ha tenido un nuevo gesto para con quienes menos tienen : ordenó construir duchas en los baños ubicados a un lado de la Plaza de San Pedro , para que sean utilizadas por los vagabundos que circundan el Vaticano , publica la agencia Notimex .	Tres miembros del grupo feminista de Femen realizaron este viernes actos obscenos con crucifijos en la Plaza de San Pedro , en el Vaticano , para protestar contra el viaje del Papa Francisco al Parlamento Europeo el 25 de noviembre .
Los dispositivos permiten a investigadores recolectar información de miles de teléfonos celulares en un solo vuelo , reportó el Journal .	Estos aparatos , apodados dirtboxes o cajas sucias , pueden recabar información de cientos de miles de usuarios en un sólo vuelo .
El escueto parte médico firmado por los doctores de la Unidad Médica Presidencial indica que la Presidente " presenta buena evolución del cuadro " .	El parte médico , firmado por los doctores Marcelo Ballesteros y Daniel Fernández , señala que la mandataria " cumple un tratamiento sintomático y antibiótico " en el sanatorio privado Otamendi de la capital argentina .
“ No había pulso , no había señales de respiración ni tampoco ritmo cardíaco ” , dijo al diario local “ Dziennik Wschodni ” , según reproduce la agencia EFE .	" Los informes hablan de una disminución del pulso , vómitos y otras dolencias que empezaron el lunes a raíz de las cirugías a las que se habían sometido " , dijo Sonmani Borah , comisionada del distrito de Bilaspur , a la agencia Afp .
Medios locales aseguraron que el volcán Kilauea inició a expulsar lava en junio pasado , la cual arribó al distrito Pahoa hasta el 26 de octubre .	El magma comenzó a fluir en junio y entró a Pahoa , el poblado más grande de la Gran Isla y al distrito agrícola de Puna , el 26 de octubre .
Estos datos deben aclarar si los cometas trajeron el agua de los océanos y las materias primas de la vida a la Tierra en los primeros tiempos del Sistema Solar .	Rosetta ayudará a descubrir si los cometas intervinieron en la formación de vida en la Tierra .
El tribunal también ha condenado a 30 años de cárcel al jefe de máquinas , a 20 años al primer oficial del ferri y a 15 años al segundo oficial , por omitir su deber de socorro cuando se hundía el buque .	Además , el jefe de ingenieros del buque fue condenado a 30 años de cárcel , y otros 13 tripulantes recibieron penas de hasta 20 años .
Miller , un joven californiano de 24 años , viajó como turista al país cuando fue detenido en abril y condenado en septiembre a seis años de cárcel con trabajos forzados , acusado de espionaje .	El joven de 24 años viajó como turista a Pyongyang y fue arrestado el pasado 26 de abril por su " comportamiento agresivo " .
El presidente chino , Xi Jinping , restó importancia hoy domingo a las preocupaciones relativas a los riesgos a que se enfrenta la economía china y apuntó que " no son tan espantosos " .	El presidente chino , Xi Jinping , propuso hoy un " sueño " para la región de Asia y el Pacífico , impulsado por la enorme economía de su país , de la que dijo que se mantiene sólida a pesar de que afronta algunos riesgos que " no son tan terribles " .
El costo de ese terreno fue de 8 millones y medio de pesos , de acuerdo con documentos del Registro Público de la Propiedad y del contrato de compra-venta suscrito ante el Notario 89 del DF .	Este predio tuvo un valor de 9 millones 850 mil pesos , como muestra el expediente del inmueble en el Registro Público de la Propiedad del DF .
En sentido contrario , apunta el estudio de PEW , el 9% de los latinoamericanos dice haber sido criado como protestante , pero en la edad adulta el 19% de ellos se reconoce en una de sus denominaciones , dejando al descubierto la transición de una iglesia a otra .	En el sondeo , el 84% dice haber sido criado en el catolicismo , 15 puntos más que los que ahora se identifican con esa religión .
El prófugo abogado Rodolfo Orellana fue capturado este jueves en la ciudad de Cali , Colombia , más de 130 días después de que el Poder Judicial ordenara su detención preventiva .	El presidente de la República , Ollanta Humala , brindó esta mañana detalles sobre la captura del abogado Rodolfo Orellana Rengifo , quien cayó este jueves en la ciudad colombiana de Cali , tras permanecer en la clandestinidad desde inicios de julio último .
Asimismo , señaló que la directiva pretende " impedir que los ciudadanos de la Unión que no ejerzan una actividad económica utilicen el sistema asistencial del Estado miembro de acogida para garantizar su subsistencia " .	En Alemania , los demandantes de empleo que necesitan asistencia pueden solicitar el seguro básico para garantizar su subsistencia .
El informe está basado en más de 30.000 entrevistas personales realizadas entre octubre de 2013 y febrero de 2014 , en 18 países de América Latina y Puerto Rico .	Las más de 30.000 entrevistas personales se realizaron en todos los países latinoamericanos hispanoparlantes menos Cuba .
Horas antes de este ataque , un palestino de 17 años apuñaló al sargento israelí Almog Shilony , de 20 años , cerca de una estación ferroviaria de Tel Aviv .	Pocas horas antes , otro palestino había herido de gravedad a un soldado israelí de 20 años con un cuchillo en la estación de tren Hagana , situada en el sur de Tel Aviv .
Ismael Zambada Imperial , alias “ El Mayito Gordo ” o “ El Mayo Gordo ” , hijo del capo Ismael “ El Mayo ” Zambada , fue capturado ayer por elementos de la Marina en El Salado , Sinaloa , junto con dos presuntos cómplices .	Ismael Zambada Imperial , conocido como ' El Mayito Gordo ' , hijo de ' El Mayo ' Zambada , fue aprehendido este miércoles en el poblado La Estancia de los Burgos , dentro de la zona de El Salado , en Culiacán , Sinaloa .
La información fue confirmada , por primera vez en su historia , por las autoridades de la Iglesia de Jesucristo de los Santos de los Últimos Días con sede en los Estados Unidos que considera a Smith como un " profeta " .	La Iglesia de Jesucristo de los Santos de los Últimos Días , que oficialmente desaprobó la poligamia a finales del siglo XIX , había intentado por años mostrar a Smith como un leal esposo a su mujer Emma .
La explosión ha tenido lugar en una escuela de la localidad de Potiskum , en la región de Yobe .	La explosión ocurrió en Potiskum , en el estado de Yobe .
Tras un análisis médico , los nuevos antecedentes señalan que Williams padecía una enfermedad mental llamada demencia de los cuerpos de Lewy , una afección neurodegenerativa .	La autopsia del actor estadounidense Robin Williams ha desvelado que además de depresión , ansiedad y Parkinson en el momento de su muerte , sufría una enfermedad llamada demencia de cuerpos de Lewy , la cual sólo se puede confirmar durante una autopsia .
Además , no hay constancia de animales desaparecidos en un parque natural situado cerca o por los propietarios de un circo que ha pasado recientemente por la zona .	El animal no pertenece al parque de atracciones , ni a un parque natural cercano o a un circo que pasó recientemente por el pueblo , según publica Le Parisien .
Además , la abogada , graduada de la Universidad de Harvard , supervisa los casos penales de Brooklyn , Staten Island , Queens y Long Island , en New York .	Pese a dirigir una de las oficinas de fiscal general más importantes del país , que abarca los distritos de Brooklyn , Queens , Staten Island y Long Island , Lynch evita siempre que puede los medios de comunicación y procura mantener un perfil bajo .
El tribunal considera que la libertad de movimientos de los ciudadanos de los países miembros de la UE no implica el derecho a beneficiarse de manera automática del sistema social de un determinado país .	En su fallo de este martes , el Tribunal resalta que , según la directiva que regula el derecho a la libre circulación de los ciudadanos de la UE , el Estado miembro de acogida no está obligado a conceder prestaciones de asistencia social durante los tres primeros meses de residencia .
En la mayoría de los países encuestados , quienes se convirtieron lo hicieron antes de los 25 años .	Según Pew , el porcentaje de católicos que abrazan el protestantismo ha aumentado constantemente en las últimas décadas en la mayoría de los 18 países y Puerto Rico donde se realizó la encuesta .
Menos de un año después , el 3 de octubre de 1990 , la Reunificación de Alemania era oficial .	Fue seguido de una reunificación entre el Este y el Oeste alemán , el 3 de octubre de 1990 .
Pero existen otras tesis a las que el juez instructor podría acogerse para someter a juicio a la duquesa de Palma .	Significa que el juez instructor , José Castro , tiene vía libre para empezar a preparar el juicio oral .
Un grupo de familiares de los 43 estudiantes de Ayotzinapa , normalistas y organizaciones sociales arrancaron una serie de caravanas que , en tres diferentes rutas , recorrerán varias ciudades del país en busca de apoyo ciudadano para que el gobierno federal clarifique la desaparición de los jóvenes y demande que la justicia se aplique para los responsables .	Un grupo de familiares y de compañeros de los 43 jóvenes desaparecidos en México arrancó el jueves en el estado de Guerrero una serie de caravanas que , en tres diferentes rutas , recorrerán varias ciudades del país para realizar actos públicos de denuncia .
Estos aparatos , apodados dirtboxes o cajas sucias , pueden recabar información de cientos de miles de usuarios en un sólo vuelo .	Los aviones son capaces de captar datos de miles de dispositivos en el transcurso de un vuelo .
En la víspera , la OSCE , encargada de hacer respetar el alto el fuego firmado el 5 de setiembre pasado por los beligerantes y que muchos consideran moribundo , alertó sobre “ el nivel de violencia en el este de Ucrania ” .	La representante de EEUU ante la ONU , Samantha Power , ha acusado al Kremlin de « atizar el conflicto » en el este de Ucrania .
La mandataria se reunió con funcionarios nacional , entre ellos el ministro de Economía , Axel Kicillof , y repasó el nivel de volumen de reservas monetarias , de depósitos bancarios y de la recaudación fiscal , se indicó .	Capitanich reseñó que la jefa de Estado estuvo reunida ayer con otros funcionarios de distintas áreas y que se efectuó un monitoreo del volumen de reservas , del volumen de depósitos , de la recaudación fiscal , y una supervisión de las variables macroeconómicas .
Un Boegin C-40 ha trasladado a Bae y Miller a suelo estadounidense , donde han aterrizado a las 9 p.m . , hora local , en la Base Lewis-McChord , próxima a la ciudad de Tacoma , en el estado de Washington .	Kenneth Bae y Matthew Todd llegaron a la medianoche de sábado para domingo a la base militar Lewis-McChord en la costa del Pacífico del estado de Washington .
El presidente de Colombia , Juan Manuel Santos , había indicado más temprano que Rodolfo Orellana sería entregado a las autoridades peruanas " entre hoy y mañana " .	Fue ubicado en la iudad de Cali y será entregado a Perú entre hoy y mañana .
Fernández de Kirchner mantuvo varias reuniones el martes , entre ellas una con los ministros de Economía , Axel Kicillof ; y de Relaciones Exteriores , Héctor Timerman , quienes representarán a la Argentina en la Cumbre del G20 que se celebrará a partir de mañana en Australia .	Los tres han hablado de la participación argentina en la cumbre del G-20 de Brisbane , a la que asistirá el canciller como cabeza de delegación .
Al menos once mujeres han muerto tras haberse sometido a una operación de ligadura de trompas en un campamento sanitario organizado por el Gobierno indio en el estado de Chhattisgarh , en el centro de India , según un nuevo balance recogido por la BBC .	Sucede que el fundador y patriarca de la Iglesia de los Santos de los Últimos Días construyó parte de su prestigio a partir del amor incondicional y exclusivo que supuestamente dedicó a su mujer .
En tanto , los presidentes de El Salvador , Salvador Sánchez Cerén , de Guatemala , Otto Pérez Molina y de Honduras , Juan Orlando Hernández , presentaron el " Plan de la Alianza para la Prosperidad del Triángulo Norte " con el objetivo de fomentar el desarrollo económico y la crecieron de empleo en sus países .	El vicepresidente habló en una conferencia del Banco Interamericano de Desarrollo , en la que los presidentes de Honduras , Guatemala y El Salvador presentaron su plan " Alianza para la Prosperidad en el Triángulo Norte " .
Los dispositivos permiten a investigadores recolectar información de miles de teléfonos celulares en un solo vuelo , reportó el Journal .	Estos aparatos , apodados dirtboxes o cajas sucias , pueden recabar información de cientos de miles de usuarios en un sólo vuelo .
El presidente ruso , Vladimir Putin , tuvo un gesto caballeroso con la primera dama de China , Peng Liyuan , durante la XXII Cumbre del Foro de Cooperación Económica Asia-Pacífico , que ha sido interpretado en medios internacionales como un “ coqueteo ” .	El incidente ocurrido durante la cumbre del Foro de Cooperación Económica Asia-Pacífico fue transmitido inicialmente por la televisora estatal CCTV y se extendió en internet .
Un total de 83 mujeres , todas menores de 32 años , pobres y de zonas rurales , fueron operadas el sábado en un hospital a las afueras de la ciudad de Bilaspur , en el estado central de Chhattisgarh , según las autoridades .	" Tenemos informes de bajadas de tensión , vómitos y otros síntomas después de que las mujeres fueran operadas en el marco de una campaña de planificación familiar " , indicó el martes a la AFP Sonmani Borah , un responsable administrativo del distrito de Bilaspur , en el Estado central de Chhattisgarh , donde el sábado se llevaron a cabo las operaciones quirúrgicas .
El periódico sostiene que una " pieza clave " del plan de Obama es permitir que muchos padres de niños que son ciudadanos estadounidenses o residentes legales obtengan permisos de trabajo y eviten así la amenaza de la deportación .	El periódico reporta que el plan protegería a cinco millones indocumentados de la deportación y entregaría permisos de trabajo .
En entrevista para la cadena de noticias CNN , Robert O’Neill , quien fue miembro del grupo élite de fuerzas especiales Navy Seal de Estados Unidos durante 15 años , afirmó que el ex líder de Al Qaeda , Osama Bin Laden , “ murió asustado como una gallina ” .	" Enviaremos a los lobos solitarios en EEUU la foto de este Robert ONeill que mató al jeque Osama Bin Laden , reza un comunicado yihadista .
La enfermedad , mejor conocida como demencia de los cuerpos de Lewy , es neurodegenerativa y llega a mostrar síntomas como deterioro cognitivo , demencia por Alzheimer , parkinson , alucinaciones y severos delirios .	La demencia con cuerpos de Lewy es una enfermedad o síndrome degenerativo y progresivo del cerebro .
mentos de la Marina detuvieron este miércoles a Ismael Zambada Imperial , el Mayo Gordo , uno de los hijos de Ismael el Mayo Zambada García , quien es uno de los líderes del Cártel de Sinaloa en el norte de México .	Las autoridades mexicanas han detenido en el noroeste del país a Ismael Zambada Imperial , alias el Mayito Gordo , uno de los hijos del líder del cártel de Sinaloa , Ismael " el Mayo " Zambada , según han informado este jueves fuentes oficiales .
La Organización sobre la Seguridad y la Cooperación en Europa informó sobre la entrada el martes en Donetsk , principal bastión prorruso , de un nuevo convoy con 43 camiones militares sin distintivo que transportaban lanzaderas de misiles y cañones .	El martes , la Organización para la Seguridad y Cooperación en Europa también denunció haber observado a 43 camiones militares rusos moviéndose hacia la frontera oriental de Ucrania .
Boko Haram , cuyo nombre significa en lenguas locales " La educación no islámica es pecado " , mantiene una sanguinaria campaña en el país que ha costado la vida a más de 3 mil personas en lo que va de año , según datos del Gobierno nigeriano .	Boko Haram , cuyo nombre significa “ la educación occidental está prohibida ” , sostiene una campaña de violencia para evitar que los niños y adolescentes asistan al colegio .
Una jornada crucial aguarda esta mañana a los presidentes de los países del Triángulo Norte de Centroamérica que integran Honduras , Guatemala y El Salvador .	" No veo ninguna razón por la que Centroamérica no pueda convertirse en la próxima gran historia de éxito en el hemisferio , y hay muchas en el hemisferio " , afirmó Biden durante una conferencia junto a los presidentes de Honduras , Guatemala y El Salvador en Washington .
Tras el revuelo que ha suscitado el ‘ mensaje leído ’ de WhatsApp , la app de mensajería instantánea ya permite a los usuarios de dispositivos Android que desactiven el ' doble check azul ' , la opción que revela si el mensaje ha sido leído e , incluso , la fecha y hora de dicha lectura .	La ' app ' de mensajería instantánea permite que los usuarios puedan volver a la calma y desactivar el doble check azul de la misma forma que se desactiva la última hora de conexión o se oculta la fotografía de perfil .
La Audiencia de Palma dará hoy a conocer su decisión sobre si ratifica o anula la imputación de la infanta Cristina en el caso Nóos al resolver los catorce recursos presentados al auto con el que finalizó la instrucción de esta causa judicial .	Tres magistrados de la Audiencia Provincial de Palma , confirmaron hoy la imputación de Cristina de Borbón por dos delitos fiscales , pero retiraron esa condición en el caso de blanqueo de capital .
También un volumen y una imagen del " Señor de los Milagros " , porque " el fervor religioso paraliza Lima " ; una camiseta de la selección peruana " para que les ayude con el padre Celestial para que Perú vuelva a estar en el Mundial " , según Humala .	Durante el intercambio de regalos , el Presidente del Perú entregó al Pontífice un bajo relieve del Señor de los Milagros y una camiseta de la selección peruana de fútbol .
El Gobierno estadounidense , que ha facilitado el regreso al país de ambos ciudadanos , aplaudió en la nota la decisión de liberarlos por parte de Pyongyang y agradece a sus aliados internacionales " especialmente al Gobierno de Suecia , por sus incansables esfuerzos para ayudar a asegurar su liberación " , añadió a su vez Efe .	En un breve comunicado de su portavoz , Ban mostró su alivio por el regreso de los dos hombres a sus hogares y alabó " el trabajo de los socios internacionales para ayudar a asegurar su liberación " , indicó a su vez Efe .
" En el caso de que los acontecimientos sean contrarios al acuerdo de Minsk , las Fuerzas Armadas están capacitadas y preparadas para repeler " , ha dicho Poroshenko , en un comunicado difundido por la Presidencia ucraniana .	Si los acontecimientos se vuelven contra el plan de paz , las Fuerzas Armadas ucranianas están hoy dispuestas y capacitadas para responder " , afirmó .
Si es aprobada por el Senado , Lynch sería la segunda mujer en ser la fiscal general del país y la primera mujer afroamericana en el cargo .	El caso ocurrió en el antiguo Hotel Sirhowy hacia las 01.23 GMT , desde donde la Policía fue informada de que un hombre identificado como Matthew Williams estaba atacando a una mujer , según esa fuerza de seguridad .
Este es el primer pronunciamiento oficial de este organismo independiente sobre su labor en las investigaciones de la desaparición de los estudiantes de la Escuela Normal Rural de Ayotzinapa el pasado 26 de septiembre .	En un comunicado , los peritos que desarrollan las investigaciones en medio de la búsqueda de los 43 estudiantes de la Normal Rural de Ayotzinapa , desaparecidos hace más de un mes , confirmaron que los restos analizados no pertenecen a los estudiantes y aseguraron que seguirán aportando a la resolución del Caso Ayotzinapa .
Rusia acusó hoy a la misión especial de monitorización de la Organización para la Seguridad y la Cooperación en Europa en Ucrania de presentar información sesgada y de apoyar a Kiev .	" Estamos preocupados por el enfoque que la misión especial de observación de la OSCE en Ucrania ha mostrado últimamente .
Kenneth Bae y Matthew Todd Miller , los dos estadounidenses liberados este sábado por Corea del Norte , han llegado en avión a la base militar Lewis-McChord de Washington , según ha informado la cadena estadounidense CNN .	Los ciudadanos estadounidenses Kenneth Bae y Matthew Todd Miller fueron liberados en Corea del Norte , según informó hoy la oficina del Director Nacional de Inteligencia de Estados Unidos , James Clapper .
Las fuerzas iraquíes recuperaron este viernes el control de la ciudad estratégica de Baiji , situada a pocos kilómetros de la mayor refinería de Irak , tras haber expulsado al grupo Estado Islámico , acusado de crímenes contra la humanidad por la ONU .	'' Las fuerzas iraquíes fueron capaces de recuperar el control completo de la ciudad de Baiji '' , dijo Ahmed al Krayim , jefe del consejo provincial de Salah ad Din .
En ese discurso , el supuesto líder de la organización yihadista hace un llamamiento a sus seguidores a atacar en Arabia Saudí , Egipto , Libia y Argelia , así como a las comunidades chiíes .	Incluso , en el audio amenaza directamente a países como Canadá y Australia , así como a Europa .
Con 55 años , y actualmente fiscal federal en el distrito neoyorquino de Brooklyn , Lynch se convertirá en la primera mujer afroamericana en ostentar ese cargo de ser confirmada por el Senado .	Loretta Lynch , una veterana fiscal federal de perfil discreto , espera la aprobación del Senado para asumir luego de la nominación que le brindó el presidente .
El presidente ruso , Vladimir Putin , tuvo un gesto caballeroso con la primera dama de China , Peng Liyuan , durante la XXII Cumbre del Foro de Cooperación Económica Asia-Pacífico , que ha sido interpretado en medios internacionales como un “ coqueteo ” .	Según dijo Hennis ante la cadena pública NOS , Putin " está mostrando la superioridad económica , política y militar de Rusia " en su " actuación desestabilizadora en el este de Ucrania " .
Asimismo , en la grabación se anuncia que esos países donde se va a expandir el EI son Arabia Saudí , Yemen , Egipto , Libia y Argelia .	El líder de Estado Islámico , Abu Bakr al Baghdadi , ha reaparecido en un supuesto discurso en el que extiende su ' califato ' a Arabia Saudí , Yemen , Egipto , Libia y Argelia .
Dijo que su objetivo es actualizar una autorización diseñada contra al-Qaida para hacerla más aplicable a la actual misión contra el grupo Estado Islámico en Irak y Siria .	Obama agregó que es demasiado pronto para decir si Estados Unidos y sus aliados están ganando su lucha contra el grupo Estado Islámico en Irak y Siria .
El joven fue hallado por las autoridades en la zona de El Salado , dominada históricamente por el Mayo , que se hizo con el poder del cártel tras la captura en febrero pasado de Joaquín " el Chapo " Guzmán .	El funcionario añadió que El Mayito Gordo , el tercer hijo de Zambada detenido en los últimos años , había conseguido un papel de liderazgo en el cartel de Sinaloa luego de que su padre asumiera la jefatura de la organización tras la captura en febrero de quien fuera su líder máximo , Joaquín El Chapo Guzmán .
Además su diagnóstico solo puede confirmarse durante una autopsia , pues es necesario examinar la corteza cerebral para detectarla .	Dicha enfermedad se producida por la acumulación anormal de proteínas en el cerebro y que lamentablemente solo se puede diagnosticar durante autopsia , pues requiere un examen meticuloso de la corteza cerebral .
El enfrentamiento se produjo después de que los maestros del estado mexicano de Guerrero atacaran la sede del Partido Revolucionario Institucional en Chilpancingo , causando numerosos destrozos y prendiendo fuego a parte de las instalaciones .	Maestros del estado de Guerrero atacaron la sede del Partido Revolucionario Institucional en Chilpancingo , una agresión que fue controlada por la policía estatal causando un enfrentamiento entre ambos .
Ayer , el EAAF , a través del centro de derechos humanos Tlachinollan , difundió su primer informe sobre este caso , tras el levantamiento de evidencias en dos lugares : Cerro Viejo y La Parota .	A través de un comunicado , el equipo dio notificación de su intervención oficial en la pesquisa .
Los presidentes de Honduras , Guatemala y El Salvador también se reunirán -a primera hora de la mañana- con la secretaria de Comercio de los Estados Unidos , Penny Pritzker , y el presidente del Banco Interamericano de Desarrollo , Luis Alberto Moreno .	Un grupo de niños de Honduras y El Salvador que cruzaron ilegalmente la frontera de Estados Unidos son detenidos en Granjeno , Texas .
Los hechos ocurrieron en las afueras de la estación de tren de Haganah , situada en el centro de Tel Aviv y muy concurrida a esa hora .	Pocas horas antes , otro palestino había herido de gravedad a un soldado israelí de 20 años con un cuchillo en la estación de tren Hagana , situada en el sur de Tel Aviv .
El Equipo Argentino de Antropología Forense , que realiza un peritaje independiente en las pesquisas sobre la desaparición de 43 estudiantes normalistas , informó que hasta ahora no hay correspondencia entre los restos humanos analizados y los jóvenes .	El Equipo Argentino de Antropología Forense informó que los restos óseos analizados hasta el momento no corresponden a ninguno de los 43 estudiantes mexicanos desaparecidos en Iguala .
Estados Unidos y China anunciaron el miércoles un plan conjunto sin precedentes para reducir las emisiones de gases de efecto invernadero para 2030 , el punto más importante de una serie de conversaciones bilaterales intensivas entre el presidente Barack Obama y su homólogo chino , Xi Jinping .	Estados Unidos y China han anunciado nuevos planes para reducir las emisiones de gases tipo invernadero , en el acuerdo más importante de la cumbre entre los líderes de los dos países .
En un verdadero encuentro récord , el turco Sultan Kösen , el hombre más alto del mundo y el nepalí Chandra Dangi , el más pequeño se reunieron en Londres , justamente para celebrar el 60 ° aniversario del libro de los récords Guiness .	La reunión entre el gigantesco turco Sultan Kösen y el diminuto nepalí Chandra Bahadur Dangi fue organizada por el libro Guinness de los récords y tuvo lugar en un jardín del centro de Londres .
El capitán del ferry surcoreano que se hundió en abril en un accidente en el que murieron 304 pasajeros fue condenado el martes a 36 años de prisión después de que un tribunal lo hallara culpable de negligencia , pero fue absuelto del cargo de homicidio , por el cual los fiscales pedían la pena de muerte .	El pasado septiembre , Sendai se convirtió en la primera planta de Japón en cumplir la nueva normativa impuesta por la NRA tras el accidente de hace más de tres años en la central de Fukushima , golpeada por un terremoto y un tsunami .
En una de las referencias , se estima que el fundador de la iglesia mormona tuvo entre 30 y 40 esposas .	En el momento de unirse , la mayoría de las mujeres tenía entre 20 y 40 años .
Diez mujeres murieron y más de 60 fueron hospitalizadas en India tras una operación de esterilización como parte de una campaña del gobierno para controlar la natalidad en este país de casi 1.250 millones de habitantes .	Campamentos como el Bilaspur forman parte de las campañas de planificación familiar para controlar el crecimiento demográfico en un país con 1.250 millones de habitantes .
En la noche del miércoles , la Organización para la Seguridad y la Cooperación en Europa informó que la semana pasado cruzaron la frontera ruso-ucraniana en ambas direcciones 665 personas con indumentaria militar .	Antes de la reunión , el secretario general de la Organización para la Seguridad y la Cooperación en Europa , Lamberto Zannier , reconoció que el alto el fuego era cada vez más virtual y que la llegada de armas a la zona rebelde podía “ llevar a una confrontación más abierta ” .
La caída del que unos denominaron " muro de la vergüenza " y otros " muralla de protección antifascista " abrió el camino hace 25 años a la reunificación de Alemania en la ciudad de Berlín y simbolizó para la posteridad el fin de la Guerra Fría .	El fin del muro de Berlín , recordó hoy Wowereit , supuso la caída del Telón de Acero y el avance de la libertad y de la democracia .
El gobierno del Estado ha abierto una investigación y los habitantes de la ciudad de Bilaspur salieron a la calle para pedir sanciones contra los médicos .	El gobierno del estado de Chhattisgarh suspendió la campaña de esterilización , ordenó una investigación sobre la muerte de las mujeres que se sometieron a la cirugía y denunció a cuatro médicos .
Un total de 83 mujeres , todas menores de 32 años , pobres y de zonas rurales , fueron operadas el sábado en un hospital a las afueras de la ciudad de Bilaspur , en el estado central de Chhattisgarh , según las autoridades .	" Tenemos informes de bajadas de tensión , vómitos y otros síntomas después de que las mujeres fueran operadas en el marco de una campaña de planificación familiar " , indicó el martes a la AFP Sonmani Borah , un responsable administrativo del distrito de Bilaspur , en el Estado central de Chhattisgarh , donde el sábado se llevaron a cabo las operaciones quirúrgicas .
Esta nueva medida permite saber si el mensaje que hemos enviado ha sido leído por el destinatario , además de la hora exacta a la que lo ha visto .	Un elemento nuevo que permite saber si tus contactos han leído el mensaje y a qué hora lo hizo .
Los dos últimos estadounidenses prisioneros en Corea del Norte , liberados gracias a una misión secreta sin precedentes en Pyongyang del jefe de inteligencia estadounidense , llegaron la noche del sábado a Estados Unidos .	Horas más tarde , el presidente estadounidense , Barack Obama , dio la bienvenida a la liberación de los dos ciudadanos estadounidenses y también enfatizó los esfuerzos del Director Nacional de Inteligencia por su implicación . “ Es un día maravilloso para ellos y sus familias .
El comunicado de la Unidad Médica Presidencial lleva la firma de los doctores Marcelo Ballesteros y Daniel Fernández .	El parte médico , firmado por los doctores Marcelo Ballesteros y Daniel Fernández , señala que la mandataria " cumple un tratamiento sintomático y antibiótico " en el sanatorio privado Otamendi de la capital argentina .
" Hasta ahora no hay información fiable disponible " , indicó un alto responsable iraquí ante la pregunta de si Abu Bakr al Baghdadi había muerto en los bombardeos de la coalición el viernes en Mosul contra lo que Estados Unidos presentó como " una reunión de dirigentes del EI " .	Según el Centcom , “ aparatos de la coalición llevaron a cabo una serie de ataques aéreos en Irak contra lo que se consideró era una reunión de dirigentes del EI cerca de Mosul ” .
Al Bagdadi se refiere también a los eventos de los últimos días y llama a su seguidores a mantener la lucha contra los “ cruzados ” .	Además , instó a los extremistas de Marruecos , Argelia , Túnez y Libia a " combatir contra los laicos " .
De nueva cuenta , la Puerta de Brandeburgo fue protagonista en la culminación de las celebraciones por la caída del Muro de Berlín en el concierto que dirigió el músico argentino-israelí Daniel Barenboim , al frente de la orquesta Staatskapelle y el coro de la Staatsoper , con la llamada Oda a la alegría .	En diciembre de 1989 , con la interpretación de la Novena Sinfonía de Beethoven se celebró en Berlín la caída del Muro y la apertura de la Puerta de Brandeburgo .
El cadáver del jefe de Al Qaeda fue finalmente lanzado al mar de Arabia en mayo de 2011 .	El miércoles se hizo pública la identidad del Navy SEAL que aseguró ser él quien descerrajó tres tiros en la frente de Bin Laden en su escondite de Abbottabad , en Pakistan , en mayo de 2011 .
El presidente de Perú , Ollanta Humala , abordará hoy con el líder ruso , Vladímir Putin , la construcción de una central nuclear en el país latinoamericano , informó un portavoz del Kremlin .	El presidente de la República , Ollanta Humala , fue recibido hoy por el líder ruso , Vladimir Putin , en su residencia campestre de Novo-Ogariovo , a las afueras de Moscú .
Spencer asistió a una conferencia de prensa en la mañana del martes junto al alcalde , Bill de Blasio .	Enviar por email Craig Spencer , el último enfermo de ébola que quedaba en Estados Unidos , saluda al alcalde de Nueva York Bill de Blasio .
La investigación del instituto PEW Research , que se apoya en estudios realizados en 18 países latinoamericanos , señala que tan sólo el 69% de los habitantes se identifican con la religión católica .	Según la investigación del instituto PEW Research , el sostenido declinar en el número de católicos en toda la región hace que en la actualidad apenas el 69% se identifiquen con esa denominación religiosa .
Uno de cada 10 latinoamericanos se criaron en el protestantismo , pero uno de cada cinco se dicen protestantes .	En ese cuadro , " aproximadamente uno de cada cuatro nicaragüenses , uno de cada cinco brasileños y uno de cada siete venezolanos se declaran como excatólicos " .
En un verdadero encuentro récord , el turco Sultan Kösen , el hombre más alto del mundo y el nepalí Chandra Dangi , el más pequeño se reunieron en Londres , justamente para celebrar el 60 ° aniversario del libro de los récords Guiness .	  El hombre más alto del mundo y el más bajo entraron al libro de los Guiness por sus estaturas récords .
El Gobierno solicitará 5.600 millones de dólares al Congreso para las operaciones en Irak y Siria , que incluirán 1.600 millones de dólares para el nuevo " Fondo de Entrenamiento y Equipamiento en Irak " , explicó la Oficina de gestión y Presupuesto de la Casa Blanca .	En junio , el gobierno pidió 58,600 millones de dólares para el presupuesto de operaciones de guerra del año fiscal en curso , que comenzó el 1 de octubre .
Todavía están bajo observación en Kayes unas 50 personas que estuvieron en contacto con la niña .	En tanto , las alrededor de 50 personas más que pudieron tener contacto con la pequeña siguen este miércoles bajo observación en Kayes , a 600 kilómetros de Bamako .
Hagel aseguró que " la causa fundamental ha sido una falta de atención y recursos sostenida " , lo que ha permitido que el arsenal nuclear " se deteriorase desde el final de la Guerra Fría " .	" La raíz del problema ha sido la falta de concentración , atención y recursos , lo que crea la sensación generalizada de que la carrera nuclear ofrece escasas oportunidades de desarrollo y avance " .
El fundador de la Iglesia Mormona , Joseph Smith , se casó con hasta 40 mujeres , entre ellas algunas casadas e incluso una adolescente de 14 años , según admitió la iglesia mormona en un sorprendente ensayo .	Smith habría " sellado " uniones , no todas consumadas , con mujeres ya casadas y con una joven de 14 años .
Janina Kolkiewicz despertó dentro de una bolsa para cadáveres horas después de que un médico hubiese certificado su fallecimiento .	Fue dentro de una bolsa para cadáveres en una casa funeraria en el este de Polonia .
Según la acusación del Ministerio Público , que acogió la corte , el religioso aprovechándose de su condición de guía espiritual del establecimiento educativo sustraía constantemente de la sala de clases a una de las niñas para cometer los abusos entre los años 2007 y 2012 .	Diez años después el sacerdote fue acusado por los padres de dos alumnas de aprovecharse de su condición de guía espiritual del establecimiento para sustraerlas constantemente de la sala de clases y abusar sexualmente de ellas .
En particular , Rosetta investiga el papel que puedan haber jugado los cometas a la hora de traer el agua a la tierra , y quizás incluso la vida .	Rosetta ayudará a descubrir si los cometas intervinieron en la formación de vida en la Tierra .
Además se descartó la sobredosis como causa de la muerte , pues según el parte oficial “ los exámenes toxicológicos revelaron la ausiencia de alcohol o drogas ” .	La oficina del sheriff de Marin indicó en un comunicado que , al realizar la autopsia a Robin Williams , los exámenes toxicológicos arrojaron la ausencia de alcohol o drogas ilícitas pero sí detectaron restos de fármacos de receta en concentraciones terapéuticas .
Las ONG denuncian la existencia de cuotas en algunos Estados de India que llevan a las autoridades a llevar a cabo esterilizaciones forzadas en condiciones higiénicas deplorables .	Grupos activistas denuncian que los incentivos de pago y las cuotas de esterilizaciones que se fijan los estados llevan a las autoridades locales a forzar a las pacientes a ser operadas , en lugar de recomendarles otros métodos anticonceptivos .
Un hombre vestido como un estudiante detonó la bomba cuando los escolares se encontraban reunidos en una asamblea antes de empezar las clases en un colegio de Potiskum , capital de la provincia de Yobe , donde actúa el grupo terrorista Boko Haram .	La tragedia podía haber sido mayor , ya que en el momento de la explosión , alrededor de las 8:00 de la mañana , hora local , estaban reunidos unos 2.000 estudiantes en una asamblea antes de empezar las clases en un colegio de Potiskum , cercano a Damaturu , capital de Yobe .
El presidente de Estados Unidos , Barack Obama , anunciará la próxima semana un amplio paquete de medidas ejecutivas en política migratoria con las que pretende evitar la deportación de más de cinco millones de personas , informó el diario " The New York Times " .	El presidente de EE.UU. , Barack Obama , anunciará la próxima semana su prometido paquete de medidas ejecutivas sobre inmigración , que incluirá la suspensión de millones de deportaciones , según una información de la cadena FOX que cita fuentes cercanas a la Casa Blanca .
A las 9.35 de la mañana , hora española , el módulo Philae fue liberado por la nave Rosetta y el contacto con el cometa se produjo a las 16.38 .	El módulo Philae se separó de Rosetta con éxito y continúa hacia el cometa .
El ministro de Exteriores de Rusia , Serguéi Lavrov , y el secretario de Estado de EEUU , John Kerry , pidieron hoy una reunión urgente entre Ucrania y los separatistas prorrusos , con mediación de Rusia y la OSCE , en Minsk .	El ministro de Exteriores ruso , Sergei Lavrov , ha defendido ante el secretario de Estado norteamericano , John Kerry , la necesidad de un " diálogo directo " entre el Gobierno ucraniano y las regiones separatistas de Donetsk y Lugansk , en el este del país .
El misterioso magnate hizo la oferta hace unos meses , pero Mujica lo dijo ahora porque el embajador de México en Uruguay , Felipe Enríquez , le manifestó al presidente su deseo de adquirir el automóvil .	“ Ya tengo un arreglo de palabra con un árabe ” , dijo entonces Mujica , con lo cual el trato se hizo de conocimiento público .
Ese personal militar no tendrá un papel de combate , sino que su misión será entrenar , asesorar y ayudar a las Fuerzas de Seguridad iraquíes , incluidas las tropas kurdas , añade Efe .	Estas tropas no combatirán en el terreno y servirán “ para entrenar , aconsejar y asistir las fuerzas de seguridad iraquíes , incluyendo las fuerzas kurdas ” , añadió .
Suecia ha sido el primer país de la UE que ha reconocido unilateralmente al Estado palestino , lo que ha provocado las protestas diplomáticas de Israel .	De momento , Suecia es el único país europeo que ha reconocido oficialmente a Palestina como Estado .
Posteriormente , dos enfermeras que formaron parte del equipo que atendió a Duncan en el Hospital Presbiteriano de la Salud de Texas en Dallas , contrajeron también el ébola .	Una semana después , las enfermeras Nina Pham y Amber Joy Vinson , que atendieron a Duncan , en el Hospital Presbiteriano de Dallas , fueron diagnosticadas con ébola .
El ex líder soviético Mijail Gorbachov , uno de los grandes responsables de la apertura del Telón de Acero , quiere interceder a favor del presidente ruso , Vladimir Putin , en su encuentro con la canciller alemana , Angela Merkel , con motivo del 25 aniversario de la caída del Muro de Berlín .	El último dirigente soviético , Mijail Gorbachov , anunció este jueves que defenderá la gestión del presidente ruso Vladimir Putin en el conflicto ucraniano cuando viaje a Alemania con motivo de los 25 años de la conmemoración de la caída del Muro de Berlín .
El presidente ruso , Vladimir Putin , tuvo un gesto caballeroso con la primera dama de China , Peng Liyuan , durante la XXII Cumbre del Foro de Cooperación Económica Asia-Pacífico , que ha sido interpretado en medios internacionales como un “ coqueteo ” .	El incidente ocurrido durante la cumbre del Foro de Cooperación Económica Asia-Pacífico fue transmitido inicialmente por la televisora estatal CCTV y se extendió en internet .
El alto tribunal comunitario , con sede en Luxemburgo , señala que los ciudadanos comunitarios que no ejerzan una actividad económica y que se trasladen a otro Estado miembro con el único objetivo de obtener una ayuda social " pueden ser excluidos de la percepción de determinadas prestaciones " .	Según el fallo , un Estado miembro « debe contar con la posibilidad de denegar las prestaciones sociales a ciudadanos de la Unión que no desarrollen una actividad económica y que ejerzan su libertad de circulación con el único objetivo de percibir la ayuda social de otro Estado miembro cuando no disponen de recursos suficientes para optar al derecho de residencia » , señala el auto .
El vicepresidente Joe Biden formuló el anuncio en el Banco Interamericano de Desarrollo , donde los mandatarios de las tres naciones centroamericanas le presentaron este viernes un plan para reducir el flujo de niños que emigran de manera irregular al norte .	El vicepresidente habló en una conferencia del Banco Interamericano de Desarrollo , en la que los presidentes de Honduras , Guatemala y El Salvador presentaron su plan " Alianza para la Prosperidad en el Triángulo Norte " .
Este martes la lava del Kilauea , volcán de la " Isla Grande " de Hawái , destruyó su primera vivienda en el pueblo de Pahoa sin dejar heridos .	10 --La lava que avanza por la Isla Grande de Hawái desde el 27 de junio se llevó este lunes a la primera casa en la ciudad de Pahoa .
Aunque los servicios de emergencia trataron de mantenerlo con vida , la descarga eléctrica de 50.000 voltios , acabó con él .	Los agentes le provocaron una descarga eléctrica de 50.000 voltios con una pistola de aturdimiento , según informó este viernes el diario “ The Independent ” .
El Departamento de Justicia recaba información de miles de teléfonos móviles mediante dispositivos similares a antenas de telefonía celular colocados en avionetas , como parte de un programa creado para obtener datos de sospechosos .	De acuerdo con el diario estadounidense The Wall Street Journal el Departamento de Justicia de Estados Unidos esía a miles de usuarios y recaba información de teléfonos móviles mediante dispositivos que simulan ser antenas de telefonía celular colocadas en avionetas .
Aunque con 425 millones de fieles , América Latina contiene el 40% de la población católica del mundo , cada vez son más los cristianos que se dicen protestantes .	América Latina posee más de 425 millones de católicos que representan casi el 40% de la población católica en todo el mundo , pero el número de fieles que busca otra denominación aumenta sostenidamente , en su mayoría en denominaciones protestantes .
Ollanta Humala da al papa Francisco una camiseta de Perú para que lo ayude a ir al mundial .	Ollanta Humala se reunió con el Papa Francisco en El Vaticano .
“ Las fuerzas iraquíes se dirigen hacia la refinería ” , ha confirmado Ahmed al Krayim , el responsable del Consejo Provincial de Saladino , al que pertenece Baiji , a la agencia France Presse .	'' Las fuerzas iraquíes fueron capaces de recuperar el control completo de la ciudad de Baiji '' , dijo Ahmed al Krayim , jefe del consejo provincial de Salah ad Din .
“ Ninguno de estos mostró probabilidad de parentesco biológico con los 43 normalistas .	" El EAAF ha obtenido resultados genéticos del Laboratorio The Bode Technology Group ubicado en Estados Unidos , sobre 24 de 30 restos recuperados en Cerro Viejo .
Las mujeres fueron operadas el sábado en un campamento de planificación familiar y a las pocas horas algunas de ellas empezaron a sentirse mal .	Las mujeres que se sometieron a la cirugía el sábado recibieron un pago de 10 dólares cada una , y las 83 fueron operadas en cuestión de seis horas , dijo el director médico del estado , el doctor S.K. Mandal a The Associated Press por teléfono .
Aunque con 425 millones de fieles , América Latina contiene el 40% de la población católica del mundo , cada vez son más los cristianos que se dicen protestantes .	América Latina posee más de 425 millones de católicos que representan casi el 40% de la población católica en todo el mundo , pero el número de fieles que busca otra denominación aumenta sostenidamente , en su mayoría en denominaciones protestantes .
El número de infectados por la epidemia de ébola en África Occidental ya ha superado las 14.098 personas contagiadas , de las cuales 5.160 han muerto , según el último informe de la Organización Mundial de la Salud .	La actual epidemia de ébola ha dejado 4.960 muertos , de un total de 13.268 casos en ocho países , por lo esencial en Liberia , Sierra Leona y Guinea , según el último balance de la Organización Mundial de la Salud .
Bae y Miller llegaron hacia las 21 , hora local , a la base conjunta Lewis-McChord en el estado de Washington .	Kenneth Bae es recibido por su familia en la Base Aérea Lewis-McChord en Fort Lewis , estado de Washington .
Sin embargo desde Kiev se negó que esté en marcha una nueva ofensiva militar en el este del país .	Medios rusos informaban esta tarde de un ataque relámpago con tanques y blindados contra las posiciones rebeldes en torno a Donetsk .
El Tribunal de Justicia de la Unión Europea confirmó que los Estados de la UE no están obligados a sostener a los ciudadanos que no ejerzan ninguna actividad económica en su nación de acogida .	El TJUE emitió hoy , martes 11 de noviembre de 2014 , una sentencia que indica que los países de la UE pueden excluir de algunas de sus ayudas sociales a los ciudadanos comunitarios que se trasladen a uno de ellos sin ejercer una actividad económica y solicitan ese tipo de prestaciones .
De esta forma , los líderes han querido publicar en la misma web información veraz sobre los aspectos más polémicos de su historia .	Sin embargo , en un esfuerzo por ser transparente sobre los aspectos más polémicos de su historia , la iglesia finalmente reveló la verdad sobre los matrimonios de su fundador en su portal oficial .
El anuncio se produjo solo un día después de que las autoridades sanitarias del país dijesen que no se habían registrado más casos -mucho menos fallecidos- luego de que una niña de dos años que viajó al país procedente de Guinea falleciese a causa del virus a finales de octubre .	Se cree que ambos nunca tuvieron contacto con el primer caso registrado en el país , una niña de dos años de edad que viajó a Malí procedente de Guinea y que falleció a causa del virus del Ébola a finales de octubre en un hospital de la ciudad de Kayes , oeste del país .
Por el hecho , unos 450 vuelos fueron cancelados por la línea aérea FlightAware en el aeropuerto internacional de la capital del estado de Minnesota .	Los ataques aéreos de la coalición internacional liderada por Estados Unidos en Irak alcanzaron una reunión de líderes del grupo yihadista Estado Islámico en las proximidades de Mosul , informaron hoy a Efe fuentes oficiales del Pentágono .
China ha enviado 252 personas a Guinea , Liberia y Sierra Leona , los tres países más afectados por la enfermedad .	Indica que en los tres países más afectados por la enfermedad el contagio sigue siendo intenso y persistente con casos semanales en todos ellos , especialmente en las capitales .
El Ejército estadounidense informó este sábado que la coalición contra el Estado Islámico lanzó el viernes de noche una serie de ataques aéreos contra dirigentes de la organización reunidos cerca de Mosul , en Irak .	Según el Centcom , " aparatos de la coalición llevaron a cabo una serie de ataques aéreos en Irak contra lo que se consideró era una reunión de dirigentes del EI cerca de Mosul " .
La mandataria , de 61 años , “ retomó ayer de manera incipiente la agenda gubernamental ” en la residencia presidencial de Olivos , en las afueras de la ciudad de Buenos Aires , informó el ministro coordinador .	La Presidenta de la Nación ha retomado ayer de una manera incipiente la agenda gubernamental , hecho que es muy trascendente , informó el jefe de Gabinete esta mañana , en su habitual encuentro con periodistas , aunque aclaró que obviamente , en el marco de la prescripción médica de reposo .
Criticaron que el presidente Enrique Peña se disponga a hacer un viaje a China y Australia , la semana próxima .	Peña Nieto llama a la paz a causa de escalada de violencia andatario , en una escala de su viaje a China y Australia , dijo que los exicanos dicen “ no a la violencia ” .
El incendio de la primera planta de una mezquita en la aldea palestina de Al-Maghir y los daños causados por el lanzamiento de un cóctel molotov en la antigua sinagoga del poblado árabe israelí de Shfaram , elevan la tensión entre israelíes y palestinos .	" Los colonos incendiaron todo el primer piso de la mezquita " en la aldea de Al Mughayir , cerca de la ciudad de Ramala , indicó un oficial de seguridad .
El protocolo de Minsk fue firmado por los representantes de Ucrania , Rusia , y las autoproclamadas repúblicas populares de Donetsk y Lugansk bajo los auspicios de la OSCE .	Los estadistas se manifestaron en contra del diálogo con los representantes de las denominadas repúblicas populares de Donetsk y de Lugansk .
Mujeres indias que se sometieron a cirugías de esterilización reciben tratamiento en el hospital CIMS en Bilaspur , en el estado central indio de Chhattisgarh , este martes .	Doce mujeres murieron en India , tras ser esterilizadas en un hospital de Bilaspur en el estado de Chhattisgarh .
Además , según supo la BBC , el líder supremo iraní , el ayatolá Ali Khamenei podría sumarse a las conversaciones .	La cita se produce después de conocerse que el presidente de EE UU , Barack Obama , envió una carta personal sobre el asunto al líder supremo iraní , el ayatolá Ali Jamenei .
El Equipo Argentino de Antropología Forense que colaboran en la investigación sobre la desaparición forzada de los 43 normalistas de Ayotzinapa concluyó que los 24 cuerpos hallados en las fosas clandestinas de Pueblo Viejo , Iguala , no son de los estudiantes , que de acuerdo con las indagaciones de la PGR , continúan como desaparecidos .	El Equipo Argentino de Antropología Forense , que realiza un peritaje independiente en las pesquisas sobre la desaparición de 43 estudiantes en México , informó hoy que analizaron 24 de 30 restos humanos y que no corresponden con los jóvenes .
El secretario general de la ONU , Ban Ki-moon , condenó hoy el atentado suicida perpetrado en una escuela en Nigeria , en el que murieron al menos 48 personas , y exigió que se lleve ante la Justicia a los responsables .	El presidente nigeriano , Goodluck Jonathan , condenó el ataque “ ruin ” , mientras que el secretario general de la ONU , Ban Ki-moon , llamó a las autoridades del país africano a apresar , juzgar y castigar a los responsables .
La India y Estados Unidos han alcanzado un acuerdo acerca del programa de subsidios agrícolas del país asiático , lo que despeja el camino para la aprobación del protocolo de Facilitación del Comercio internacional , informó hoy la ministra india de Comercio , Nirmala Sitharaman .	" La India y Estados Unidos han resuelto el punto muerto sobre la seguridad alimentaria en la Organización Mundial del Comercio " , publicó Sitharaman en su cuenta de twitter .
La Audiencia indica en el auto de ayer que existe un « matiz » diferencial entre el caso de las cesiones de crédito y el caso Nóos .	El Supremo ratificó en 2007 la decisión previa de la Audiencia Nacional en el caso de las cesiones de crédito de que " no puede abrirse juicio oral sólo a instancias de la acusación popular , sino que es necesario que lo inste bien el Ministerio Fiscal , bien el acusador particular " .
China ha enviado 252 personas a Guinea , Liberia y Sierra Leona , los tres países más afectados por la enfermedad .	La OMS alertó sin embargo que en los tres países más afectados por la enfermedad el contagio sigue siendo intenso y persistente , con casos semanales en todos ellos , especialmente en las capitales .
" No atender un evento como éste sería actuar con irresponsabilidad " , dijo Peña Nieto durante un mensaje a medios efectuado en Anchorage , durante una escala de su viaje a China .	No se puede exigir justicia actuando con violencia " , dijo en un mensaje a medios en Anchorage , Alaska , en su primera escala previo a su gira por China y Australia .
Ayer , estudiantes de la Normal Rural Raúl Isidro Burgos de Ayotzinapa y familiares de los 43 jóvenes normalistas desaparecidos , realizaron un acto solemne en la escuela para despedir a los tres grupos que visitarán ocho estados y municipios de Guerrero para relatar la matanza , y conformar un solo movimiento nacional .	Por la mañana , padres de familia de los 43 normalistas desaparecidos realizaron ayer una marcha en la ciudad de Tixtla para exigir que sus hijos sean presentados con vida .
El fundador de la Iglesia Mormona , Joseph Smith , se casó con hasta 40 mujeres , entre ellas algunas casadas e incluso una adolescente de 14 años , según admitió la iglesia mormona en un sorprendente ensayo .	La Iglesia mormona admitió que su fundador , Joseph Smith , se casó con unas 40 mujeres -incluida una adolescente de 14 años y otras que ya estaban casadas con sus seguidores- tras mantener por casi 200 años que había sido monógamo .
" El Consejo General de la OMC va a recibir la propuesta de la India y Estados Unidos la apoyará " , destacó la ministra india .	India presentará su propuesta ante el Consejo General de la OMC en su reunión de diciembre .
Aprovechando que esta Alianza Transpacífica se ha quedado estancada por las diferencias comerciales entre EE.UU. y Japón , China está impulsando su propia Área de Libre Comercio .	EE.UU. y China se van a disputar el rol rector en el Área de Libre Comercio .
El capitán del buque surcoreano Sewol , cuyo naufragio causó 304 muertos , evitó la pena de muerte al ser condenado hoy a 36 años de cárcel como máximo responsable de la tragedia , mientras las autoridades dieron por concluidos los trabajos de rescate del barco , aunque todavía hay nueve desaparecidos .	El capitán del ferry surcoreano que se hundió en abril en un accidente en el que murieron 304 pasajeros fue condenado el martes a 36 años de prisión después de que un tribunal lo hallara culpable de negligencia , pero fue absuelto del cargo de homicidio , por el cual los fiscales pedían la pena de muerte .
Fue el gobernador de Kagoshima , Yuichiro Ito , el que dio el visto bueno en la Asamblea de la prefectura para la reactivación de los dos reactores atómicos de agua a presión de la planta de Sendai , situada en el extremo meridional de la isla de Kyushu , la segunda más poblada del país asiático .	El gobernador Yuichiro Ito ha aprobado la reapertura de dos reactores , que empezarían a operar después de cumplirse las últimos procedimientos técnicos a principios del próximo año .
Igual que el contingente actual , los nuevos efectivos entrenarán y asistirán a las fuerzas de seguridad iraquíes y kurdas en su lucha contra el grupo yihadista Estado Islámico , que controla partes de Irak y Siria , según informó el Pentágono .	Obama agregó que es demasiado pronto para decir si Estados Unidos y sus aliados están ganando su lucha contra el grupo Estado Islámico en Irak y Siria .
En la actualidad , el Pentágono gasta alrededor de 15 mil millones de dólares en su programa nuclear , por lo que la inversión adicional rondaría los 7 mil 500 millones .	El Pentágono gasta en la actualidad alrededor de 15.000 millones de dólares en el programa nuclear , apuntó Hagel .
Grupo Higa , a través de su filial Constructora Teya , integra el consorcio de empresas nacionales y extranjeras al que le fue revocada la licitación para construir el tren de alta velocidad México-Querétaro .	Grupo Higa está el nombre de la misma empresa a la que le fue retirada la licitación del tren rápido México-Querétaro .
El joven fue hallado por las autoridades en la zona de El Salado , dominada históricamente por el Mayo , quien asumió el liderazgo del cártel tras la captura en febrero pasado de Joaquín " el Chapo " Guzmán .	En el caso de la joven de 14 años , Helen Mar Kimball , hija de un amigo cercano de Joseph Smith , el matrimonio fue solo para la eternidad con lo que , según dice el ensayo , que apunta que en esa época era legal casarse con chicas de esa edad , no habría implicado relaciones sexuales .
Horas antes de este ataque , un palestino de 17 años apuñaló al sargento israelí Almog Shilony , de 20 años , cerca de una estación ferroviaria de Tel Aviv .	Pocas horas antes , otro palestino había herido de gravedad a un soldado israelí de 20 años con un cuchillo en la estación de tren Hagana , situada en el sur de Tel Aviv .
El presidente de la República , Ollanta Humala , fue recibido hoy por el líder ruso , Vladimir Putin , en su residencia campestre de Novo-Ogariovo , a las afueras de Moscú .	El Presidente de la República , Ollanta Humala Tasso , se reunió hoy con su homólogo de Rusia , Vladimir Putin , en el marco de la visita oficial que desarrolla en dicho país , que comprendió encuentros previos con altas autoridades .
Un equipo de científicos japoneses ha logrado crear ratones transparentes lo que , según explican , permite observar sus órganos y estudiar la evolución de enfermedades como el cáncer o la diabetes sin la necesidad de diseccionar .	“ El proceso también se puede utilizar para resaltar grupos concretos de células . ”
Antes de la reunión , el secretario general de la Organización para la Seguridad y la Cooperación en Europa , Lamberto Zannier , reconoció que el alto el fuego era cada vez más virtual y que la llegada de armas a la zona rebelde podía “ llevar a una confrontación más abierta ” .	El martes , la Organización para la Seguridad y Cooperación en Europa también denunció haber observado a 43 camiones militares rusos moviéndose hacia la frontera oriental de Ucrania .
Iglesia mormona admitió que su fundador se casó con 40 mujeres Joseph Smith se casó con varias esposas y autorizó a otros a practicar el atrimonio plural " , dice un ensayo de la Iglesia .	La Iglesia mormona admitió que su fundador , Joseph Smith , se casó con unas 40 mujeres -incluida una adolescente de 14 años y otras que ya estaban casadas con sus seguidores- tras mantener por casi 200 años que había sido monógamo .
El gobierno del estado ha iniciado una investigación sobre el caso y promete " tomar medidas estrictas contra los culpables " .	El gobierno del estado de Chhattisgarh suspendió la campaña de esterilización , ordenó una investigación sobre la muerte de las mujeres que se sometieron a la cirugía y denunció a cuatro médicos .
" Los informes preliminares indican que los medicamentos administrados eran falsos y también que el equipo utilizado estaba oxidado " , dijo un alto cargo del gobierno local , Siddharth Singh Komal Pardeshi , a Reuters .	" Los informes preliminares muestran que las medicinas utilizadas no eran las adecuadas y que los instrumentos estaban oxidados " , ha explicado a la agencia Reuters Siddarth Komal Singh , un alto cargo del Gobierno local .
Una polaca de 91 años , Janina Kolkiewicz , despertó dentro de una bolsa para cadáveres en un tanatorio de Ostrów Lubelski once horas después de que una médico hubiese certificado su fallecimiento .	: La doctora Wieslawa Cyz , responsable de certificar el fallecimiento de Janina Kolkiewicz , aseguró que estaba “ totalmente convencida ” de que la mujer había muerto .
Un grupo de familiares de los 43 estudiantes de Ayotzinapa , normalistas y organizaciones sociales arrancaron una serie de caravanas que , en tres diferentes rutas , recorrerán varias ciudades del país en busca de apoyo ciudadano para que el gobierno federal clarifique la desaparición de los jóvenes y demande que la justicia se aplique para los responsables .	Los familiares de 43 estudiantes mexicanos desaparecidos desde septiembre iniciaron el jueves una marcha nacional para presionar al gobierno a poner más atención al caso .
Según el Ejército de EEUU , " aviones de la coalición llevaron adelante ayer de noche una serie de ataques aéreos en Irak contra lo que se cree que era un encuentro de dirigentes del ISIS cerca de Mosul " , la segunda ciudad del país , ubicada en el norte y bajo control del grupo de radicales islamistas .	" Puedo confirmar que aviones de la coalición realizaron una serie de ataques aéreos ayer por la noche en Irak contra lo que fue evaluado como una reunión de líderes de ISIL cerca de Mosul " , comentó Ryder , que usó un acrónimo para Estado Islámico .
Bajo la atenta mirada de cientos de miles de espectadores , unos 7,000 globos se lanzaron a lo largo de 15 kilómetros del antiguo trazado del muro con el cuarto movimiento de la novena sinfonía de Beethoven , basado en la Oda a la Alegría del escritor alemán Friedrich von Schiller , de fondo .	El despegue de esta " Frontera de luz " , como se llama el proyecto de globos , al son de la conocida composición de Beethoven , himno de la Unión Europea y basada en la Oda a la Alegría del escritor alemán Friedrich von Schiller , constituía el momento álgido de las conmemoraciones .
La mayoría de los casos y de las muertes han ocurrido en Sierra Leona , Liberia y Guinea .	Recordó que hay cerca de 3.500 profesionales de la salud de MSF que están trabajando ahora en Liberia , Sierra Leona y Guinea Conakry , los países más afectados , algunos de los cuales han muerto .
El presidente estadounidense , Barack Obama , ha expresado su agradecimiento por la liberación este sábado de los ciudadanos estadounidenses Kenneth Bae y Matthew Todd Miller , que cumplían penas de trabajos forzados en Corea del Norte .	Los ciudadanos estadounidenses Kenneth Bae y Matthew Todd Miller han llegado a EE.UU. tras haber sido liberados por Corea del Norte .
El hombre más alto del mundo se casa con una siria .	El nepalí ostenta el título actualmente de ser el hombre más pequeño con vida y el más diminuto de la historia .
Loretta Lynch se convirtió ayer en la primera afroestadounidense postulada para la Secretaría de Justicia .	El presidente estadunidense Barack Obama hizo oficial hoy la nominación de la fiscal federal de Nueva York , Loretta Lynch , para ser procuradora de Justicia de Estados Unidos , en sustitución de Eric Holder .
Según la cadena Fox News , Obama podría anunciar un plan de diez puntos en materia de inmigración tan pronto como el 21 de noviembre , previo a las festividades del Día de Acción de Gracias , que usualmente se celebra el 24 de noviembre en todo el territorio estadounidense .	Ayer , la cadena televisiva Fox News dijo que Obama prevé presentar , tan pronto como el próximo 21 de noviembre , un plan de diez puntos para modificar las políticas migratorias mediante una acción ejecutiva .
Robert James O'Neill fue el hombre que aparentemente mató a Osama bin Laden en Abbotabad el 1 de mayo de 2011 .	Y , efectivamente , en el tercer piso de la vivienda fue donde O'Neill afirma que mató a Bin Laden .
La caravana Daniel Solís Gallardo visitará Chiapas , Oaxaca , Morelos , Tlaxcala y finalizará en el Distrito Federal .	La segunda saldrá este jueves por la tarde hacia Chiapas , Oaxaca , Morelos y Tlaxcala y la tercera lo hará el sábado , aunque se limitará a la zona de Guerrero .
El módulo Philae ha colocado con éxito un termómetro en la superficie del cometa , mientras los científicos han recibido un flujo constante de datos procedentes de la sonda .	El módulo de descenso tuvo una accidentada llegada a la superficie del cometa 67P / Churyamov-Gerasimenko , a 510 millones de kilómetros de la Tierra .
El convenio se suma al acuerdo alcanzado en mayo para que la estatal rusa Gazprom provea 38.000 millones de metros cúbicos de gas al año a China usando los depósitos en Siberia Oriental .	" La ruta occidental prevé el suministro de gas a China desde los yacimientos de gas en Siberia occidental .
El juez expuso en su sentencia que el capitán fue el máximo responsable del trágico final del naufragio , ya que retrasó la orden de evacuación , no tomó las medidas oportunas cuando el barco comezó a hundirse y posteriormente no realizó esfuerzos para rescatar a los pasajeros .	Lee admitió en el juicio que el pánico le paralizó y que no pudo tomar las " medidas adecuadas " para tratar de salvar a los pasajeros .
La liberación ha sido el resultado de los contactos mantenidos por el director de la Inteligencia Nacional estadounidense , James Clapper , con las autoridades del régimen estalinista .	Ya están de camino a casa acompañados por el director Nacional de Inteligencia de Estados Unidos , James Clapper .
La policía mata a un caníbal cuando se comía a una mujer en un hotel de Gales	Policiales a un caníbal que se estaba comiendo la cara de una mujer Gales del Sur El hombre , de 34 años , había salido de prisión hace dos semanas por violencia de género .
El Pentágono tendrá que gastarse miles de millones de dólares durante los próximos cinco años para reparar su arsenal nuclear , según anunciará el secretario de Defensa , Chuck Hagel , este viernes y ya ha adelantado el diario estadounidense ' The New York Times ' , después de que dos estudios del Pentágono concluyeran que hay " problemas sistémicos afectando a la industria nuclear " .	El Pentágono invertirá miles de millones de dólares para actualizar su arsenal e infraestructura nuclear , luego que informes internos revelaran una serie de “ problemas sistémicos ” de mantenimiento y de falta de personal , anunció este viernes el secretario de Defensa , Chuck Hagel .
La fiscalía había pedido la pena de muerte para Lee Joon-Seok , de 69 años , tras haber abandonado a su suerte a los 476 pasajeros del ferry cuando zozobró el 16 de abril .	El Tribunal de Distrito de Gwangju declaró a Lee Joon-seok , de 68 años , culpable de homicidio accidental , ya que escapó del buque sin atender a la seguridad de los pasajeros durante el naufragio del 16 de abril , en el que murieron 304 personas , de los que 9 continúan desaparecidos .
Rodolfo Orellana está acusado de blanqueo de dinero y asociación para delinquir , además de ser investigado por narcotráfico .	Orellana estaba prófugo en Perú desde hace más de 130 días y , además de afrontar los cargos se le imputan , es investigado en su país por presuntos nexos con el narcotráfico .
Hagel aseguró que " la causa fundamental ha sido una falta de atención y recursos sostenida " , lo que ha permitido que el arsenal nuclear " se deteriorase desde el final de la Guerra Fría " .	" La raíz del problema ha sido la falta de concentración , atención y recursos , lo que crea la sensación generalizada de que la carrera nuclear ofrece escasas oportunidades de desarrollo y avance " .
Quizá no lo consigamos ” , reconoció el presidente estadounidense Barack Obama , en una entrevista emitida por el canal CBS .	Quizá no lo consigamos " , reconoció el presidente estadounidense haciendo referencia a un acuerdo sobre la política nuclear iraní antes de la fecha límite del 24 de noviembre .
Los tres han hablado de la participación argentina en la cumbre del G-20 de Brisbane , a la que asistirá el canciller como cabeza de delegación .	Fernández de Kirchner mantuvo varias reuniones el martes , entre ellas una con los ministros de Economía , Axel Kicillof ; y de Relaciones Exteriores , Héctor Timerman , quienes representarán a la Argentina en la Cumbre del G20 que se celebrará a partir de mañana en Australia .
La Iglesia de Jesucristo de los Santos de los Últimos Días , que oficialmente desaprobó la poligamia a finales del siglo XIX , había intentado por años mostrar a Smith como un leal esposo a su mujer Emma .	La Iglesia de Jesucristo de los Santos de los Últimos Días ha intentado encubrir aspectos de su historia , como la poligamia practicada por Smith y Brigham Young , quien colaboró en la fundación de la ciudad Salt Lake City , en Utah , donde se ubica la sede central de la institución .
El ex líder soviético Mijail Gorbachov , uno de los grandes responsables de la apertura del Telón de Acero , quiere interceder a favor del presidente ruso , Vladimir Putin , en su encuentro con la canciller alemana , Angela Merkel , con motivo del 25 aniversario de la caída del Muro de Berlín .	“ Defenderé con firmeza a Rusia y a su presidente Vladimir Putin ” , en el foro político que tendrá lugar el domingo al margen de las celebraciones en Berlín , declaró Gorbachov a la agencia rusa Interfax .
El peruano Rodolfo Orellana , detenido hoy en la ciudad colombiana de Cali por supuestamente crear una gran trama criminal en su país , dijo en una breve declaración ante las cámaras de televisión que es " un perseguido político " .	El empresario peruano Rodolfo Orellana , prófugo de la justicia de su país donde se le acusaba de dirigir una red criminal , fue detenido hoy en la ciudad de Cali en una operación conjunta entre las autoridades peruanas y colombianas , con el apoyo de Interpol y la DEA .
Bae y Miller llegaron hacia las 21 , hora local , a la base conjunta Lewis-McChord en el estado de Washington .	Kenneth Bae es recibido por su familia en la Base Aérea Lewis-McChord en Fort Lewis , estado de Washington .
" Eso pone fin al bloqueo de la OMC y abre la vía al Acuerdo de Facilitación del Comercio " , afirmó en un comunicado la ministra india de Comercio , Nirmala Sitharaman .	" La India y Estados Unidos han resuelto el punto muerto sobre la seguridad alimentaria en la Organización Mundial del Comercio " , publicó la ministra india de Comercio , Nirmala Sitharaman , en su cuenta de Twitter .
Medios rusos informaban esta tarde de un ataque relámpago con tanques y blindados contra las posiciones rebeldes en torno a Donetsk .	Nos atacan y nosotros nos defendemos " , ha asegurado Andréi Purguín , viceprimer ministro de la autoproclamada república popular de Donetsk , a la agencia oficial rusa RIA-Nóvosti .
Rusia acusó hoy a la misión especial de monitorización de la Organización para la Seguridad y la Cooperación en Europa en Ucrania de presentar información sesgada y de apoyar a Kiev .	Recientemente , los separatistas pidieron una revisión del mecanismo de control de los acuerdos de paz de Minsk con el argumento de que la Organización para la Seguridad y la Cooperación en Europa no puede garantizar el alto el fuego declarado el 5 de septiembre pasado .
“ Sus ojos estaban muy abiertos , pero no eran sensibles a la luz ” , añadió la médica , quien confesó estar avergonzada por haber expedido el certificado de defunción de una paciente que aún estaba viva .	“ No había pulso , no había señales de respiración ni tampoco ritmo cardíaco ” , dijo al diario local “ Dziennik Wschodni ” , según reproduce la agencia EFE .
Obama , quien llegó hoy a Beijing para participar en la cumbre del foro de Cooperación Económica Asia-Pacífico , buscó mostrarse amable con sus anfitriones al reconocer que " no esperamos que China siga el modelo estadounidense en cada situación " , informó la agencia de noticias EFE .	Obama asistió a la 22º Reunión de Líderes de Economías del Foro de Cooperación Económica Asia-Pacífico y realizará una visita de Estado a China .
Al menos once mujeres han muerto tras haberse sometido a una operación de ligadura de trompas en un campamento sanitario organizado por el Gobierno indio en el estado de Chhattisgarh , en el centro de India , según un nuevo balance recogido por la BBC .	Una joven de 22 años fue asesinada en un acto de canibalismo en la localidad galesa de Argoed y el supuesto autor murió al recibir disparos de un policía con una pistola Taser , informó hoy la cadena BBC .
Tras varios meses de negociaciones , el portal alcanzó un acuerdo con la agencia de derechos Merlin , que representa a unos 20.000 sellos discográficos independientes de 39 países .	Los sellos discográficos que representan el 95% de la industria de la música ya habían suscrito el acuerdo , pero Merlin , que representa a más de 20.000 compañías de 39 países no lo había hecho .
La llamada del presidente se produjo luego que la última persona que estaba siendo monitoreada en relación con los casos de ébola , concluyó este viernes el tiempo de supervisión tras cumplirse el plazo de 21 días , periodo de incubación del mortal virus .	Zuckerberg , el presidente de la compañía , ha señalado que , a pesar de que el objetivo de Facebook es ofrecer información de las personas a las que tienes agregadas como amigos , los usuarios de la plataforma cada vez utilizaban más el servicio de mensajería .
El incendio de la primera planta de una mezquita en la aldea palestina de Al-Maghir y los daños causados por el lanzamiento de un cóctel molotov en la antigua sinagoga del poblado árabe israelí de Shfaram , elevan la tensión entre israelíes y palestinos .	" Los colonos incendiaron todo el primer piso de la mezquita " en la aldea de Al Mughayir , cerca de la ciudad de Ramala , indicó un oficial de seguridad .
Como ya no confían en la Comisión Estatal de Derechos Humanos los maestros pidieron la intervención de Vidulfo Rosales Sierra , abogado del Centro de Derechos Humanos de la Montaña , quien llevaría al funcionario a un lugar en el que la policía del estado entregaría también a los maestros detenidos .	Después de algunas horas , los maestros entregaron al oficial a la organización Centro de Derechos Humanos de la Montaña Tlachinollán , que también conforma la defensa de los padres de los estudiantes desaparecidos .
Moscú critica los informes de la organización que salvaguarda el cumplimiento de los acuerdos de paz de Minsk porque " contienen datos exhaustivos sobre la movilización de las unidades militares de las repúblicas populares de Donetsk y Lugansk " .	Además , confirmó que los rebeldes se mantienen fieles “ al formato de Minsk con participación de Rusia , la OSCE , las repúblicas de Donetsk y Lugansk , y también Ucrania ” .
Rusia acusó hoy a la misión especial de monitorización de la Organización para la Seguridad y la Cooperación en Europa en Ucrania de presentar información sesgada y de apoyar a Kiev .	El Ministerio ruso de Exteriores acusó hoy a la misión de la OSCE encargada de observar el alto el fuego en Ucrania de tratar de ayudar a las autoridades de Kiev .
En principio estaba previsto que la delegación uruguaya viajara a las 6:30 hora local , pero recién pudo hacerlo pasadas las 10:30 local .	Se prevé que el vuelo de la delegación uruguaya llegue a Brasilia a las 13:45 hora local y Mujica se entreviste con Rousseff en el Palacio presidencial Planalto a partir de las 15:00 horas .
Sturgeon , hasta ahora " número dos " del SNP , ha sido declarada oficialmente este viernes líder en el comienzo del congreso anual de la formación que se celebra en la ciudad escocesa de Perth .	La que era hasta ahora número dos de la formación independentista sustituye en el puesto a Alex Salmond .
La policía de Gales del Sur , irrumpió en la habitación de un hotel cuando Matthew Williams le estaba comiendo la cara a una mujer .	El hecho se registró en la habitación de un hotel de la localidad galesa de Argoed .
La explosión ha tenido lugar en una escuela de la localidad de Potiskum , en la región de Yobe .	La matanza se produce una semana después de que un ataque suicida similar segara la vida de veinte personas en la escuela islámica Faydia de Potiskum , que pertenece a un grupo de la rama chiíta del islam .
Amás , los misioneros apunten que los númberos d'infectaos puen ser " hasta dos o hasta cuatro veces más grandes " que los oficiales .	Los cadáveres de personas fallecidas pueden ser hasta diez veces más contagiosos que los infectados vivos .
El hombre mató a cuchilladas a Dalia Lemkus , una mujer de 25 años originaria de la colonia de Tekoa , e hirió a dos hombres de 26 y 50 años .	Asimismo , las fuerzas de seguridad israelíes detuvieron en Hebrón al hermano del hombre que presuntamente apuñaló a una mujer de 25 años causándole la muerte , y causó heridas a otras dos personas junto a una colonia judía en Cisjordania , según la misma agencia .
La aeronave intentaba aterrizar el domingo en la isla de Gran Bahama , hasta el momento se desconoce la causa del accidente .	Los ataques aéreos de la coalición internacional liderada por Estados Unidos en Irak alcanzaron una reunión de líderes del grupo yihadista Estado Islámico en las proximidades de Mosul , informaron hoy a Efe fuentes oficiales del Pentágono .
Una vez que estés en ajustes , solo debes pulsar en ' Info de cuenta ' y , ahí , en ' Privacidad ' .	Una vez instalada , sólo hay que dirigirse a Ajustes y entrar en la pestaña de Privacidad .
Cabe recordar que Sendai se convirtió en la primera planta de Japón el pasado mes de septiembre en respetar los nuevos estándares de la NRA .	El pasado septiembre , Sendai se convirtió en la primera planta nipona en cumplir la nueva normativa impuesta por la NRA tras el accidente de hace más de tres años en la central de Fukushima , golpeada por un terremoto y un tsunami .
Josh Earnest , secretario de prensa de la Casa Blanca , señaló que Obama revisaría las recomendaciones finales al regresar la próxima semana de su viaje a Asia .	En la misma línea se expresó el portavoz de la Casa Blanca , Josh Earnest , que acompaña a Obama en su gira y dijo a los periodistas que el mandatario recibirá “ pronto ” las “ recomendaciones finales ” de su secretario de Seguridad Nacional , Jeh Johnson .
Purguín aseguró que el régimen de alto el fuego no se respeta en el 75 por ciento de la virtual línea de separación entre ambos bandos .	Coincidiendo con la reanudación de los combates en torno a Donetsk , los separatistas anunciaron hoy que propondrán la revisión de los acuerdos de Minsk , que incluyen una declaración de alto el fuego y una línea de separación entre ambos bandos en conflicto .
La presidenta reapareció ayer a través de mensajes en la red social Twitter , en los que informó sobre la decisión de su Gobierno de retirar la candidatura de la argentina Susana Ruiz Cerutti para la Corte Internacional de Justicia para dejar paso al candidato de Jamaica .	La primera aparición pública se produjo pero , este miércoles por la noche a través de Twitter cuando la presidenta anunció que Argentina retiraba la candidatura de la embajadora Susana Ruiz Cerutti del Tribunal Internacional de Justicia .
“ Mi tía sufre demencia senil y no es consciente de lo que ha sucedido ” dijo Kolkiewicz .	Fuentes de su familia explicaron que la señora sufre de demencia y que aparentemente no está consciente de lo cerca que estuvo de la muerte .
Desde Colombia , el presidente Juan Manuel Santos dijo que conversó por teléfono con Humala sobre el tema y que entregaría al detenido a las autoridades peruanas a más tardar el viernes .	El presidente de Colombia , Juan Manuel Santos , había anunciado horas antes que Orellana , que se encuentra detenido , será entregado a las autoridades peruanas " entre hoy y mañana " .
El presidente uruguayo , José Mujica , visitó hoy a la presidenta brasileña , Dilma Rousseff , para celebrar su reelección el pasado octubre , pero la oportunidad también sirvió para que volviera a pedir su apoyo para la construcción de un puerto de aguas profundas en Uruguay .	presidente uruguayo , José Mujica , fue recibido hoy en Brasilia por la jefa de Estado brasileña , Dilma Rousseff , a quien ha querido felicitar personalmente por su reelección en los comicios de octubre pasado .
La actualización para Android si se quiere desactivar el ‘ doble check azul ’ aún no está disponible en Google Play , pero sí en la página web de WhatsApp .	Por el momento esta opción sólo se encuentra disponible para los usuarios de Android para lo que la compañía ha lanzado la versión 2.11.444 que , aunque no está disponible en Google Play puede ser descargada a través de la web de WhatsApp .
La policía abatió a un caníbal cuando devoraba a una mujer Matthew Williams , de 34 años , fue sorprendido en la madrugada mordiendo el rostro de una joven a la que había invitado a su hotel .	La policía de Gales del Sur mató a un caníbal cuando se estaba comiendo la cara de una mujer de 22 años en la habitación de un hotel .
" En el caso de que los acontecimientos sean contrarios al acuerdo de Minsk , las Fuerzas Armadas están capacitadas y preparadas para repeler " , ha dicho Poroshenko , en un comunicado difundido por la Presidencia ucraniana .	Si los acontecimientos se vuelven contra el plan de paz , las Fuerzas Armadas ucranianas están hoy dispuestas y capacitadas para responder " , afirmó .
El viceministro de Política Interior y Seguridad Jurídica , José Vicente Rangel Ávalos , señaló que antes de que el pueblo eligiera al presidente Hugo Chávez , “ La tortura estaba institucionalizada y el asesinato político era frecuente ” en Venezuela .	En la sede del Alto Comisionado de la ONU para Derechos Humanos en Ginebra , la delegación de Venezuela , liderada por el viceministro de Política Interior y Seguridad Ciudadana , José Vicente Rangel Ávalos , fue cuestionada sobre el cumplimiento de su país de la Convención contra la Tortura y otros Tratos Crueles , Inhumanos y Degradantes .
Otros tres responsables del ferry fueron condenados a penas de entre 15 y 30 años de cárcel y otros once tripulantes fueron sentenciados a entre cinco y diez años .	Tribunal ha puesto penas de entre 30 y cinco años de cárcel a otros 14 miembros de la tripulación .
Esta vez , el examen reveló que el artista padecía de demencia de cuerpos de Lewy y que , además , no se había intoxicado al momento de su suicidio , en agosto de este año .	La demencia de cuerpos de Lewy se produce debido a la acumulación anormal de proteínas en el cerebro .
Todavía están bajo observación en Kayes unas 50 personas que estuvieron en contacto con la niña .	Sin embargo , el lunes el optimismo creció en Malí tras levantarse la cuarentena a 25 de las 108 personas que pudieron tener contacto con la niña fallecida .
Una marea humana acudió al centro de Berlín , bloqueando la circulación entre la Puerta de Brandeburgo y Postdamer Platz , para presenciar este espectáculo , que cierra un fin de semana de festejos en la capital alemana .	Miles de personas se reunirán en torno al símbolo de la unidad alemana , la Puerta de Brandeburgo en Berlín .
“ Los padres de niñas y mujeres solteras temen que sus hijas sean forzadas a casarse con combatientes de ISIS y como resultado el matrimonio infantil está al alza .	El informe también destaca las violaciones a las mujeres , y el hecho de que familias aterrorizadas casan de forma precipitada a sus hijas para que no sean forzadas a casarse con los combatientes del grupo EI .
Una vez que estés en ajustes , solo debes pulsar en ' Info de cuenta ' y , ahí , en ' Privacidad ' .	Una vez instalada , lo único que hay que hacer es dirigirse a Ajustes y entrar en la pestaña de Privacidad .
Los responsables de la misión Rosetta no saben cuánto tiempo sobrevivirá la sonda Philae en el cometa 67P , ya que dependerá de las condiciones que haya encontrado allí .	La nave Rosetta completaba la maniobra de cambio de trayectoria para enviar la sonda Philae hacia el cometa 67P.
El presidente uruguayo José Mujica , que ganó fama mundial por su austeridad , estudia la insólita oferta de un jeque árabe que le propuso un millón de dólares por su viejo Volkswagen Fusca de 1987 , informó el jueves el semanario Búsqueda .	El presidente uruguayo , José Mujica , dio a entender hoy en Brasilia que sigue analizando la venta de su viejo " Fusca " de Volkswagen , después de que un jeque árabe le ofreciera un millón de dólares .
Ocho mujeres murieron y otras cuatro se encuentran en estado crítico tras someterse a cirugías de esterilización en un campamento de planificación familiar gubernamental en el centro de la India , informó hoy a Efe una fuente oficial .	Al menos 11 mujeres han muerto y más de 60 permanecen hospitalizadas , 14 en estado crítico , tras someterse a una cirugía de trompas , en el marco de una campaña de esterilización voluntaria en el estado de Chhattisgarh , en el centro de India .
Otros tres autobuses tendrán como destino el norteño estado de Chihuahua y recorrerán Durango , Zacatecas , Jalisco y Michoacán , mientras que otros tres se dirigirán al sureño estado de Oaxaca , con escalas en Morelos y Tlaxcala .	El jueve por la trade saldría una tercera caravana , también formada por tres autobuses , hacia el sureño estado de Oaxaca , que incluye escalas en Morelos y Tlaxcala .
Un video de Circuito Cerrado de Televisión sobre el incidente muestra Khyr al Din Hamdan , de 22 años , corriendo hacia un vehículo policial , armado de un puñal y golpeando repetidamente con su arma las ventanas del rodado .	Un video de una cámara de vigilancia muestra a un joven que se abalanza contra un auto de policía , golpeando una de las ventanas .
También , se detalló que el EAAF ha intervenido en la exhumación de dos de los 30 restos recuperados en Cerro Viejo/ Pueblo Viejo , Iguala , Guerrero , y el examen forense de los 30 restos .	" El EAAF ha obtenido resultados genéticos del Laboratorio The Bode Technology Group ubicado en Estados Unidos , sobre 24 de 30 restos recuperados en Cerro Viejo .
Los comunicados indicaron que China y Japón también " reconocieron que existen posiciones diferentes entre ellos " sobre las tensiones por las islas en el Mar de China Meridional y acordaron establecer un mecanismo de manejo de crisis para evitar " contingencias " .	También manifiestan conocer las diferencias existentes en cuanto a la soberanía de islas en el Mar de China Meridional y Oriental , y acuerdan " prevenir la escalada de tensiones a través del diálogo y la consulta " así como establecer " mecanismos de gestión de crisis para evitar contingencias " .
Las tres brigadas concluirán su recorrido en el Zócalo de la ciudad de México , el próximo 20 de noviembre , con un mitin político para exigir el esclarecimiento del caso en el que están involucrados policías municipales de Iguala .	Las tres caravanas , denominadas en su conjunto Brigada Nacional de los 43 Desaparecidos , se encontrarán en el Zócalo del Distrito Federal el próximo 20 de noviembre .
" Es una fiscal independiente que en dos ocasiones ha dirigido una de las fiscalías más importantes del país " , señaló el vocero de la presidencia , Josh Earnest .	" A lo largo de sus 30 años de carrera , se ha distinguido como una persona férrea , justa y una abogada independiente que ha dirigido en dos ocasiones una de las oficinas legales más prominentes de Estados Unidos " , subrayó el mandatario .
Las páginas operaban en la red anónima Tor , un software que permite la anonimidad en internet , de modo que no se podía acceder a ellas a través de los buscadores tradicionales .	Los expertos consideran que el cierre representa un hito en la lucha contra el crimen cibernético y destacan el uso de nuevas técnicas por parte de la policía para rastrear la ubicación física de los servidores .
Putin confirmó que en la cumbre de Brisbane mantendrá un encuentro bilateral con la canciller alemana , Angela Merkel , y " muchos otros encuentros " .	Obama arribará a Brisbane el sábado y conversará sobre sus frustrados esfuerzos en favor de Ucrania con un grupo clave de líderes de naciones aliadas , entre ellos la canciller alemana , Angela Merkel , el presidente francés , Francois Hollande , y Cameron .
El ministerio de Defensa de Rusia no hizo de inmediato declaraciones sobre las afirmaciones de Lysenko , pero refutó nuevamente los señalamientos occidentales de que Moscú incrementó su despliegue de tropas cerca de la frontera .	El Ministerio de Defensa de Rusia rechazó las acusaciones de Kiev y aseguró que esas afirmaciones carecen de base alguna y son “ una provocación ” .
El presidente uruguayo , José Mujica , dijo hoy después de una reunión de unas tres horas con la jefa de Estado brasileña Dilma Rousseff , que la reelección de la mandataria en los comicios de octubre ha renovado la integración latinoamericana .	El presidente de Uruguay , José Mujica , dijo hoy tras una reunión en Brasil con la presidenta brasileña Dilma Rousseff que su reelección refuerza la integración latinoamericana , y destacó la buena relación existente entre los dos países .
" En casi todos los países encuestados , al menos un tercio de los actuales protestantes fueron criados como católicos y la mitad o más dicen que fueron bautizados " , dice el informe .	En Colombia , por ejemplo , nada menos que el 74% de los declarados protestantes afirman haber sido criados como católicos .
La presidenta de Argentina , Cristina Fernández , recibió eldomingo el alta médica tras permanecer una semana hospitalizada por un cuadro de sigmoiditis y se dirigió a la residencia oficial , donde deberá guardar reposo otros 10 días .	La presidenta argentina Cristina Fernández fue dada de alta el domingo , tras permanecer siete días internada en una clínica privada de Buenos Aires debido a un cuadro de infección intestinal .
En estos últimos años , ha respaldado la entrada de Palestina como Estado observador no miembro de la ONU y su ingreso en la UNESCO .	París ya apoyó la entrada de Palestina en la agencia cultural de Naciones Unidas , la UNESCO , y su papel como observador no miembro de las ONU .
Frente al riesgo de una escalada militar , el Consejo de Seguridad de la ONU convocó a una reunión de urgencia hoy en Nueva York .	Después de que EU y varios países europeos denunciaran la entrada en Ucrania de convoyes militares con armamento pesado desde Rusia , el Consejo de Seguridad de la ONU advirtió el miércoles del riesgo de que las actuales hostilidades deriven en " combates a gran escala " .
El incidente ocurrido durante la cumbre del Foro de Cooperación Económica Asia-Pacífico fue transmitido inicialmente por la televisora estatal CCTV y se extendió en internet .	El momento fue captado por la cadena de televisión CCTV durante la cena tras la cumbre del Foro de Cooperación Económica Asia-Pacífico , que reunió a 21 líderes mundiales , entre ellos el presidente mexicano , Enrique Peña Nieto , y el estadounidense Barack Obama .
La tecnología del dispositivo , de unos 60 centímetros cuadrados , permite a investigadores recabar datos de decenas de miles de celulares con un solo vuelo .	Los aviones son capaces de captar datos de miles de dispositivos en el transcurso de un vuelo .
El tribunal condenó por homicidio al ingeniero jefe del barco por no ayudar a dos miembros de la tripulación heridos , lo que lo convirtió en el único de los cuatro en enfrentar cargos por homicidio y ser acusado de ese delito , y fue condenado a 30 años de prisión .	Los 13 miembros restantes de la tripulación del ferry Sewol que sobrevivieron fueron hallados culpables de varios cargos , incluido negligencia , y condenados a periodos de entre cinco a 20 años de prisión .
El drama se desarrolló a la altura de la planta 69 del edificio , también conocido como " Torre de la Libertad " , que ocupa parte del espacio que dejaron las Torres Gemelas , destruidas por los atentados terroristas del 11 de septiembre de 2001 .	Aparentemente el cable se desató mientras uno de trabajadores subía a la cima de la torre , la más alta de Estados Unidos .
El peruano Rodolfo Orellana , detenido hoy en la ciudad colombiana de Cali por supuestamente crear una gran trama criminal en su país , dijo en una breve declaración ante las cámaras de televisión que es " un perseguido político " .	El empresario peruano Rodolfo Orellana , prófugo de la justicia de su país donde se le acusaba de dirigir una red criminal , fue detenido hoy en la ciudad de Cali en una operación conjunta entre las autoridades peruanas y colombianas , con el apoyo de Interpol y la DEA .
Sin embargo , las autoridades esperan que las autopsias detallen con precisión la causa de las muertes .	Las investigaciones Las autoridades afirmaron que desconocen las causas de las muertes y que solo las autopsias determinarán lo ocurrido .
El envío consiste en 32 tanques , 16 obuses de tipo D-30 y 30 camiones de tipo KamAZ con munición y soldados ” , informó en una rueda de prensa Andrey Lysenko , portavoz del Consejo .	" 32 tanques , 16 obuses y 30 camiones militares Kamaz con tropas entraron en Ucrania desde Rusia " y se dirigen a la ciudad de Krasni Luch , en la región de Lugansk , declaró el portavoz .
« He venido en un momento en el que , por todo el mundo , Estados Unidos está liderando desde una posición de fuerza » , dijo en tono victorioso Obama en un discurso pronunciado en un foro de líderes empresariales en el marco de la cumbre del Foro de Cooperación Económica Asia-Pacífico .	Entre esos retos , citó la lucha contra el ébola , el cambio climático o la proliferación nuclear , según afirmó Obama en un discurso en un foro de líderes empresariales de la cumbre del Foro de Cooperación Económica Asia-Pacífico , que se celebra entre hoy mañana en la capital de la potencia asiática .
La app creó una nueva versión beta de la app 2.11.444 que ya están disponibles en la página oficial y solo es compatible para el sistema Android , OS 2.1 o superiores .	Debes tener en cuenta que la app solo es compatible con la versión de Android 2.1 o superior .
Agencias La Policía de Gales del Sur mató a un hombre al que sorprendió comiéndose la cara de una mujer de 22 años en la habitación de un hotel .	La policía abatió a un caníbal cuando devoraba a una mujer Matthew Williams , de 34 años , fue sorprendido en la madrugada mordiendo el rostro de una joven a la que había invitado a su hotel .
Ollanta Humala se reúne mañana con el Papa Francisco .	El Papa Francisco mantuvo hoy una audiencia privada con el presidente Ollanta Humala , en el Vaticano .
El equipo médico presidencial , al que nadie podrá acusar de dilapidar información , emitió un escueto comunicado en el que señala : “ La Sra. Presidenta de la Nación , Dra. Cristina Fernández de Kirchner , presenta buena evolución del cuadro de sigmoiditis que la afecta .	En un escueto parte médico difundido este mediodía por la Unidad Médica Presidencial , se indica que el alta de la mandataria fue firmada en función " de la buena evolución del cuadro de sigmoiditis que la afecta " .
La imagen de Putin siendo caballeroso con la primera dama china rápidamente recorrió las redes sociales .	Medios de alrededor del mundo han titulado la noticia como “ Putin corteja a la Primera Dama china ” o “ Vladimir Putin coquetea con la primera dama de China , Peng Liyuan ” .
Alex Salmond , que guió a Escocia a su primer referéndum sobre la independencia , pronunciará un discurso de despedida .	En la sesión de esta tarde del congreso , Alex Salmond , que permanecerá como diputado en el Parlamento autónomo , pronunciará después de las 15.00 GMT un discurso de despedida ante sus compañeros de la formación nacionalista .
El último parte médico previo al alta , difundido el sábado , comunicó que la jefa de Estado argentina presentaba “ una buena evolución clínica e imagenológica ” , pero omitió decir cuándo sería dada de alta y podría reincorporarse a sus funciones .	Según el último parte del sábado por la noche , la Presidenta cursaba su internación " por un cuadro de sigmoiditis " con " buena evolución clínica e imagenológica " .
En su intervención , Toyberg-Frandzen dijo que la situación en Donetsk y Lugansk se asimila a la que había antes de los acuerdos de alto el fuego firmados en Minsk el 5 de septiembre pasado por el Gobierno de Ucrania y los rebeldes prorrusos .	En la víspera , la OSCE , encargada de hacer respetar el alto el fuego firmado el 5 de septiembre pasado por los beligerantes y que muchos consideran moribundo , alertó sobre " el nivel de violencia en el este de Ucrania " .
Estados Unidos compareció ante el Comité contra la Tortura de la ONU , que entre hoy y mañana revisará si Washington ha cumplido desde 2006 con la Convención contra la Tortura y Otros Tratos o Penas Crueles , Inhumanos o Degradantes .	En México , la tortura y los malos tratos que siguen a la detención de personas y antes de que éstas sean puestas a disposición de la justicia , son una práctica generalizada y se presentan en un contexto de impunidad , según un reporte que la Cámara de Diputados recibió de Juan Méndez , Relator Especial de la Organización de Naciones Unidas sobre la tortura y otros tratos o penas crueles , inhumanos o degradantes .
También este viernes 150 personas participaron en el funeral de dos adolescentes que murieron el miércoles en un bombardeo cerca de una escuela de Donetsk .	Ayer se realizaron los funerales de dos niños que murieron el miércoles por la caída de un proyectil en su escuela de Donetsk .
Armados con bates de madera , machetes , arcos , flechas y armas de fuego artesanales para caza , un grupo de estos Vigilantes logró liberar este miércoles la ciudad de Maiha , que estaba bajo control de los salafistas .	Hace dos días otro grupo de cazadores locales también lograron recuperar la ciudad de Maiha , a unos 25 kilómetros de Mubi , que también estaba bajo control de los terroristas .
El director general de la ESA , Jean-Jacques Dordain , calificó el aterrizaje de Philae sobre el cometa 67 / P Churyumov-Gerasimenko como " un gran paso para la civilización humana " .	Los aviones son capaces de captar datos de miles de dispositivos en el transcurso de un vuelo .
Armados con bates de madera , machetes , arcos , flechas y armas de fuego artesanales para caza , un grupo de estos Vigilantes logró liberar este miércoles la ciudad de Maiha , que estaba bajo control de los salafistas .	Hace dos días otro grupo de cazadores locales también lograron recuperar la ciudad de Maiha , a unos 25 kilómetros de Mubi , que también estaba bajo control de los terroristas .
Según fuentes cercanas explicaron que la enfermedad habría sido clave para que el protagonista de ' Patch Adams ' tomara la decisión de quitarse la vida .	Los médicos del actor creen que la enfermedad fue un aspecto crucial que pudo empujar a Robbin Williams a tomar la decisión de quitarse la vida .
Perú y Rusia están cooperando en el ámbito de defensa con la transferencia de tecnologías y con coproducción , dijo hoy el presidente peruano , Ollanta Humala .	Se trata de la primera visita de un presidente de Perú a Rusia en los 45 años de relaciones diplomáticas , por lo que ha sido calificada de " histórica " por ambas partes .
La comisaria europea de Comercio , Cecila Malmstrom , recordó a través de un comunicado que los acuerdos de Bali están destinados a liberalizar los intercambios globales en el marco de la Organización Mundial del Comercio .	El acuerdo de Facilitación del Comercio , el primero de índole global que se alcanzó en la última reunión ministerial de la OMC , el pasado diciembre en Bali y establece decenas de medidas para facilitar el flujo de bienes en las aduanas , reducir la burocracia y con ello multiplicar los intercambios comerciales entre países .
Diez mujeres murieron y más de 60 fueron hospitalizadas en India tras una operación de esterilización como parte de una campaña del gobierno para controlar la natalidad en este país de casi 1.250 millones de habitantes .	Al menos 11 mujeres han muerto y más de 60 permanecen hospitalizadas , 14 en estado crítico , tras someterse a una cirugía de trompas , en el marco de una campaña de esterilización voluntaria en el estado de Chhattisgarh , en el centro de India .
Los familiares quieren solicitar la colaboración de estados Unidos en la búsqueda de sus hijos desaparecidos .	Los familiares aseguraron que , mientras no haya pruebas , seguirán exigiendo la búsqueda de sus hijos vivos , y que solo confiarán en los datos que les proporcionen los peritos argentinos .
Magistrados de la Sala Penal del Supremo consultados por este periódico creen que esas diferencias no son relevantes y consideran que la aplicación de la doctrina Botín a la hermana del Rey es jurídicamente ineludible .	Jueces del Supremo opinan , por el contrario , que si Castro no aplica la doctrina Botín « estaría jugando con fuego » .
El ex líder soviético Mijail Gorbachov , uno de los grandes responsables de la apertura del Telón de Acero , quiere interceder a favor del presidente ruso , Vladimir Putin , en su encuentro con la canciller alemana , Angela Merkel , con motivo del 25 aniversario de la caída del Muro de Berlín .	El ex presidente de la Unión Soviética Mijaíl Gorbachov , ha afirmado este jueves que defenderá a Rusia y a su presidente , Vladímir Putin , durante su visita a Alemania con motivo de los actos conmemorativos del 25 aniversario de la caída del Muro de Berlín , que se cumple el próximo domingo , " En las conversaciones con personalidades y dirigentes políticos tendré una postura firme de defensa de Rusia y , por tanto , de su presidente , Vladímir Putin " , ha dicho Gorbachov en declaraciones a la agencia Interfax .
Centenares de banderas palestinas , y sobre todo del movimiento Al Fatah que lideró , así como de Suecia – que ha reconocido un Estado palestino- eran ondeadas por los asistentes .	También se han podido ver banderas de Suecia , país que ha reconocido a Palestina como estado .
La Organización Mundial de la Salud ha actualizado este miércoles su balance de víctimas por el brote de ébola en África Occidental y ha rebajado a 4.818 el número de fallecidos , después de descontar 440 muertos como víctimas del virus en Sierra Leona .	La Organización Mundial de la Salud reportó la víspera que cuatro mil 818 personas han muerto por el ébola en África Occidental y que el número de casos seguía aumentando en Sierra Leona , aunque se está estabilizando en Guinea y disminuyendo en Liberia .
Si es aprobada por el Senado , Lynch sería la segunda mujer en ser la fiscal general del país y la primera mujer afroamericana en el cargo .	De ser confirmada por el Senado , Lynch se convertiría en la primera mujer negra en el cargo y seguiría al primer secretario de Justicia de la nación de raza negra .
Así lo asegura la web TMZ , citando fuentes cercanas a la familia del fallecido , que revela que el actor sufría demencia con cuerpos de Lewy .	La noticia , fue confirmada por fuentes cercanas a la familia , según lo señaló el portal TMZ .
En la misma línea , el experto dijo que le consta que se han denunciado " muchas más " de las 183 violaciones a los derechos humanos y 166 casos de malos tratos oficialmente registrados , " ¿ es así?,"¿cuántas " ?	El Relator pidió precisar el número de personas que han denunciado ser víctimas de violaciones a derechos humanos , y cuántas de éstas han sido investigadas .
El Gobierno estadounidense , que ha facilitado el regreso al país de ambos ciudadanos , aplaudió en la nota la decisión de liberarlos por parte de Pyongyang y agradece a sus aliados internacionales " especialmente al Gobierno de Suecia , por sus incansables esfuerzos para ayudar a asegurar su liberación " , añadió a su vez Efe .	En un breve comunicado de su portavoz , Ban mostró su alivio por el regreso de los dos hombres a sus hogares y alabó " el trabajo de los socios internacionales para ayudar a asegurar su liberación " , indicó a su vez Efe .
Mark Zuckerberg , el CEO de la compañía , se encargó de responder las preguntas de los propios usuarios de Facebook a través de una sesión de " Preguntas & Respuestas " .	A finales de octubre el área de comunicación convocó a todos los usuarios de la red a participar en una sesión de preguntas y respuestas con el fundador de Facebook .
El Ejército ucraniano se prepara para acciones militares en el este del país por parte de las milicias prorrusas , para lo que ha procedido a reagrupar sus fuerzas en la zona , anunció hoy el ministro de Defensa de Ucrania , Stepán Poltorak .	El Ejército de Ucrania se prepara para posibles acciones militares en el este del país por parte de las milicias prorrusas , después de que la OTAN haya denunciado este miércoles la presencia de los convoyes militares y militares de Rusia en el este de Ucrania .
Una marcha de docentes y estudiantes en Chilpancingo , capital de Guerrero , terminó con la sede del oficialista PRI incendiada .	La tensa marcha de maestros y estudiantes en Chilpancingo , capital de Guerrero , a 275 kms . de Ciudad de México , por la muerte de 43 estudiantes .
La presidenta de Chile , Michelle Bachelet , visitará China la próxima semana con motivo de la cumbre del foro de Cooperación Económica Asia-Pacífico y realizará una visita de trabajo bilateral , informaron hoy fuentes oficiales .	La presidenta de Chile , Michelle Bachelet , buscó durante su primer día de visita en China incrementar su cooperación económica con Rusia y los países de la Unión Aduanera en una reunión con su homólogo ruso , Vladímir Putin , al margen de la cumbre de empresarios del foro APEC celebrada hoy en Pekín .
Loretta Lynch apenas celebra ruedas de prensa , concede entrevistas o da discursos en su puesto actual como fiscal federal en Brooklyn .	Lynch , que creció en Greensboro , Carolina del Norte , comenzó su carrera como fiscal federal en 1990 .
Las autoridades sanitarias de Malí han confirmado dos nuevas muertes por el virus en sus fronteras .	Mali registró dos nuevas muertes por ébola no relacionadas con el primer caso documentado en el país , indicaron las autoridades del estado de África occidental .
La arqueóloga explicó que la tumba pertenecía a un hombre que murió en los años de Alejandro el Magno .	En el pasado , arqueólogos dijeron que la tumba posiblemente pertenecía a un macedonio importante y que el lugar había sido saqueado .
El fallo va contra quienes “ acuden a Alemania con el único objetivo de aprovecharse de su sistema social ” , añadió el democristiano Peter Tauber .	Sin embargo , según el derecho germano , quienes se desplacen a Alemania con el único objetivo de beneficiarse de estas prestaciones o de buscar trabajo quedan excluidos .
Los bomberos de Nueva York lograron rescatar a dos trabajadores que limpiaban cristales en la nueva torre del World Trade Center y que se habían quedado colgados hoy en el piso 69 , al desprenderse parte del cableado de su andamio .	Equipos de rescate de los bomberos de Nueva York acudieron esta tarde a la nueva Torre del World Trade Center en el centro financiero de Manhattan , donde un andamio de los que sirven para limpiar los vidrios exteriores del edificio quedó colgando en el piso 68 de manera peligrosa .
El Equipo Argentino de Antropología Forense informó que los restos óseos analizados hasta el momento no corresponden a ninguno de los 43 estudiantes mexicanos desaparecidos en Iguala .	El Equipo Argentino de Antropología Forense , que realiza un peritaje independiente en las pesquisas sobre la desaparición de 43 estudiantes en México , informó hoy que hasta ahora no hay correspondencia entre los restos humanos analizados y los jóvenes .
La doctora Wieslawa Cyz , responsable de certificar el fallecimiento de Janina Kolkiewicz , aseguró que estaba “ totalmente convencida ” de que la mujer había muerto .	“ No había pulso , no había señales de respiración ni tampoco ritmo cardíaco ” , dijo al diario local “ Dziennik Wschodni ” , según reproduce la agencia EFE .
" La raíz del problema ha sido la falta de concentración , atención y recursos , lo que crea la sensación generalizada de que la carrera nuclear ofrece escasas oportunidades de desarrollo y avance " .	También subrayó la necesidad de “ incrementar ” el “ personal nuclear ” y hacer frente “ a la sensación generalizada de que una carrera en el programa nuclear ofrece pocas oportunidades para crecer y progresar ” , al comentar la “ baja moral ” existente entre los integrantes del programa .
Las autoridades de Estados Unidos anunciaron hoy que Bae y Miller están de camino a sus casas tras recibir permiso para abandonar Corea del Norte .	Kenneth Bae y Matthew Todd Miller han recibido permiso para abandonar la República Popular Democrática de Corea .
Igual de risueño , Amr paseaba con orgullo por la Mukata , a los pies del mausoleo , una bandera de Suecia , que destacaba entre los cientos de blasones de Al Fatah , escudos de la Organización para la Liberación de Palestina y enseñas nacionales palestinas .	" Nos han privado de este aniversario , pero la historia no perdonará a los que frenan el plan de Abu Amar para la liberación de Palestina " .
El papa siempre ha mostrado una gran atención por estas personas que duermen bajo las columnas de San Pedro y en los alrededores , y manda a Krajewski a que les de dinero y artículos de primera necesidad como comida y mantas .	El papa autorizó la construcción de las tres duchas en el interior de los baños que normalmente usan los peregrinos .
Obama , que se topa con el escepticismo y la negación total del cambio climático en el Congreso estadounidense , se ha fijado como meta que Estados Unidos reduzca sus emisiones entre un 26% y un 28% para 2025 , en comparación con los niveles de 2005 .	Por su parte , Estados Unidos reducirá sus emisiones para 2025 entre un 26 y un 28 por ciento con respecto a los niveles de 2005 , lo que supone el doble del recorte previsto entre 2005 y 2020 .
Las visitas de los fieles judíos al sitio — conocido por los judíos como Monte del Templo y por los musulmanes como Explanada de las Mezquitas — han generado preocupación entre los musulmanes sobre que Israel pueda estar intentando hacerse con el control del lugar en secreto .	Bajo un arreglo , Jordania tiene derechos de custodia sobre sitios sagrados musulmanes en Jerusalén , incluyendo el complejo conocido por los judíos como el Monte del Templo y por los musulmanes como el Noble Santuario .
La detención estuvo a cargo de un fiscal de la Dirección Especializada de Fiscalía contra el Crimen Organizado de Colombia con el apoyo de la Policía y la DEA .	Miller , de 24 años , fue condenado a seis años por la Corte Suprema de Corea del Norte después de ser detenido por supuestamente romper su visa y pedir asilo .
La policía de Gales del Sur , irrumpió en la habitación de un hotel cuando Matthew Williams le estaba comiendo la cara a una mujer .	El caso ocurrió en el antiguo Hotel Sirhowy hacia las 01.23 GMT , desde donde la Policía fue informada de que un hombre identificado como Matthew Williams estaba atacando a una mujer , según esa fuerza de seguridad .
Osama bin Laden , líder de Al Qaeda , y uno de los hombres más buscados por Estados Unidos fue abatido el 1 de mayo de 2011 en su escondite en Pakistán .	El cadáver del jefe de Al Qaeda fue finalmente lanzado al mar de Arabia en mayo de 2011 .
Todos los pacientes en situación de riesgo han sido controlados durante 21 días , periodo máximo de incubación de la enfermedad , por si tenían síntomas propios del ébola , como fiebre , vómitos , diarrea o sangrado .	Todos ellos han sido sometidos a dos controles de temperatura diarios en busca de síntomas de ébola .
Al menos veinte jóvenes palestinos de nacionalidad israelí fueron arrestados hoy por la Policía en una creciente ola de protestas de la minoría árabe de Israel , tras la muerte el viernes de un joven a manos de agentes policiales en una localidad de la Galilea .	La comunidad árabe de Israel protestó el domingo contra la muerte de un joven abatido a tiros por la policía en una localidad próxima a Nazaret , en un episodio más de la violencia que vive esta región .
La fiscalía pedía pena de muerte para el marino del ferry , que se hundió en Corea del Sur .	La fiscalía había pedido la pena de muerte para Lee Joon-Seok , de 69 años , tras haber abandonado a su suerte a los 476 pasajeros del ferry cuando zozobró el 16 de abril .
El capitán del buque surcoreano Sewol , cuyo naufragio causó 304 muertos , evitó la pena de muerte al ser condenado hoy a 36 años de cárcel como máximo responsable de la tragedia , mientras las autoridades dieron por concluidos los trabajos de rescate del barco , aunque todavía hay nueve desaparecidos .	La prefectura japonesa de Kagoshima aprobó hoy reactivar la primera central atómica en Japón tras el parón nuclear provocado por el accidente de Fukushima en 2011 , pese a la oposición de la opinión pública y la población local .
Recordó además que el jefe de la delegación , José Vicente Rangel Avalos , viceministro de Política Interior y Seguridad Ciudadana , dijo durante su intervención que Venezuela es firmante de la Convención , " cuya observancia es obligante " .	En la sede del Alto Comisionado de la ONU para Derechos Humanos en Ginebra , la delegación de Venezuela , liderada por el viceministro de Política Interior y Seguridad Ciudadana , José Vicente Rangel Ávalos , fue cuestionada sobre el cumplimiento de su país de la Convención contra la Tortura y otros Tratos Crueles , Inhumanos y Degradantes .
La respuesta de Hamas no tardó en llegar : todo esto no son más que " mentiras " , " insultos " y " desinformación " , cuando " el pueblo palestino necesita a un presidente valiente " , diez años después de la muerte de su icono nacional .	Líder palestino acusa a Israel de perpetuar ' guerra religiosa ' en aniversario de la muerte de Yaser Arafat .
El robot Philae de la sonda espacial europea Rosetta se posó hoy sobre un cometa a más de 510 millones de kilómetros de la Tierra , un hito sin precedentes en la historia de la conquista espacial .	El cometa Chury se encuentra actualmente viajando entre las órbitas de Júpiter y de Marte , a más de 450 millones de kilómetros de la Tierra .
Además , calcula los números de infectados son « hasta dos o hasta cuatro veces más grandes » que los oficiales .	Los cadáveres de personas fallecidas pueden ser hasta diez veces más contagiosos que los infectados vivos .
Salmond , que en 1987 fue elegido diputado de la Cámara de los Comunes por la demarcación escocesa de Banff & Buchan , tan solo hizo una alusión irónica a esa cuestión al inicio de su intervención .	Salmond no ha descartado aspirar a un escaño en la Cámara de los Comunes , dentro de seis meses .
La mandataria , de 61 años , “ retomó ayer de manera incipiente la agenda gubernamental ” en la residencia presidencial de Olivos , en las afueras de la ciudad de Buenos Aires , informó el ministro coordinador .	La mandataria , de 61 años , debe cumplir por prescripción médica 10 días de reposo y se encuentra a día de hoy en la residencia presidencial de Olivos .
En abril de 2013 fue condenado por el Tribunal Supremo norcoreano por actos hostiles contra el país y sentenciado a 15 años de trabajos forzados .	Miller , de 24 años , fue condenado a seis años por la Corte Suprema de Corea del Norte después de ser detenido por supuestamente romper su visa y pedir asilo .
La coalición liderada por Estados Unidos está registrando un “ avance constante y sostenible ” en su combate contra los militantes de EI en Irak y Siria , pero advirtió que “ será una lucha larga y difícil ” . “ Habrá reveses .	El canal 2 de la televisión israelí informó que las 400 viviendas en Har Homa y las 600 en Har Shlomo son parte de un acuerdo alcanzado por el ministro de Economía , Naftali Bennett , del partido procolono Casa Judía a cambio de la promesa de estabilidad en la coalición de gobierno .
La censura china se ha apresurado a eliminar de internet un vídeo que muestra cómo un caballeroso Vladimir Putin cubre los hombros de la primera dama del país asiático , Peng Liyuan , con una capa durante la cena de gala celebrada con motivo de la cumbre del Foro de Cooperación Económica Asia-Pacífico .	El presidente ruso , Vladimir Putin , tuvo un gesto caballeroso con la primera dama de China , Peng Liyuan , durante la XXII Cumbre del Foro de Cooperación Económica Asia-Pacífico , que ha sido interpretado en medios internacionales como un “ coqueteo ” .
Según el Ejército de EEUU , " aviones de la coalición llevaron adelante ayer de noche una serie de ataques aéreos en Irak contra lo que se cree que era un encuentro de dirigentes del ISIS cerca de Mosul " , la segunda ciudad del país , ubicada en el norte y bajo control del grupo de radicales islamistas .	" Puedo confirmar que aviones de la coalición realizaron una serie de ataques aéreos ayer por la noche en Irak contra lo que fue evaluado como una reunión de líderes de ISIL cerca de Mosul " , comentó Ryder , que usó un acrónimo para Estado Islámico .
Rusia , que desmiente cualquier implicación en el conflicto en el este de Ucrania , en el que murieron más de 4.000 personas desde abril pasado , denunció las acusaciones formuladas en Sofía por Philip Breedlove , comandante en jefe de la OTAN .	La OSCE y la OTAN han constatado la entrada en el este de Ucrania desde territorio ruso de equipamiento , tanques , artillería , sistemas de defensa antiaérea e incluso tropas en ayuda de las milicias separatistas .
Desde que el módulo se separó de la sonda , " la misión se dividió en dos " , aunque Rosetta sigue siendo " fundamental " ya que Philae la necesita para comunicarse con la Tierra .	Desde Malargüe se reciben las comunicaciones de la sonda , que demoran casi 25 minutos en llegar a la Tierra .
Al menos once mujeres han muerto tras haberse sometido a una operación de ligadura de trompas en un campamento sanitario organizado por el Gobierno indio en el estado de Chhattisgarh , en el centro de India , según un nuevo balance recogido por la BBC .	Once mujeres han muerto y más de cincuenta se encuentran hospitalizadas después de someterse a una cirugía de esterilización masiva del gobierno en el estado de Chhattisgarh , en el centro de India .
El EAAF indicó en un comunicado que ha intervenido en la exhumación y , en algunos casos , en el análisis de los restos hallados en las zonas de Cerro Viejo y La Parota , en el municipio de Iguala , y en Cocula en el basurero y en la orilla del Río San Juan .	Otro de las trabajos fue el levantamiento de restos humanos y evidencia asociada a los mismos en el Basurero de Cocula y a la vera del Río San Juan , en Cocula , Guerrero .
El año 1989 estuvo lleno de sucesos históricos para la Unión Soviética , donde la caída del Muro de Berlín no tuvo la misma importancia que en Occidente .	El último dirigente de la Unión Soviética , Mijaíl Gorbachov , se reunirá con la canciller alemana Angela Merkel durante los festejos por el 25 aniversario de la caída del Muro de Berlín .
El presidente de Perú , Ollanta Humala , se reúne hoy con el jefe del Kremlin , Vladímir Putin , en la primera jornada de su visita a Rusia , la primera de un jefe de Estado de ese país latinoamericano en 45 años de relaciones diplomáticas .	Los presidentes de Perú , Ollanta Humala , y Rusia , Vladímir Putin , impulsaron hoy los lazos bilaterales en distintos ámbitos durante la primera visita oficial de un mandatario peruano a este país en 45 años de relaciones diplomáticas .
Desde 2010 es fiscal federal del distrito Este de Nueva York , un puesto que había ocupado entre 1999 y 2001 bajo la presidencia de Bill Clinton .	El Senado confirmó dos veces a Lynch como fiscal federal del Distrito Este de Nueva York , primero desde 1999 al 2001 y de nuevo en el 2010 , y la funcionaria cuenta con sólidos apoyos en la base demócrata .
Magistrados de la Sala Penal del Supremo consultados por este periódico creen que esas diferencias no son relevantes y consideran que la aplicación de la doctrina Botín a la hermana del Rey es jurídicamente ineludible .	El abogado de la infanta , Miquel Roca , atiende a los medios tras la imputación de la hermana del rey .
En Alemania , los demandantes de empleo que necesitan asistencia pueden solicitar el seguro básico para garantizar su subsistencia .	La directiva pretende , señala el fallo , " impedir de ese modo que los ciudadanos de la Unión que no ejerzan una actividad económica utilicen el sistema asistencial del Estado miembro de acogida para garantizar su subsistencia " .
El anuncio se produjo solo un día después de que las autoridades sanitarias del país dijesen que no se habían registrado más casos -mucho menos fallecidos- luego de que una niña de dos años que viajó al país procedente de Guinea falleciese a causa del virus a finales de octubre .	La confirmación de los dos muertos se produce cuando Malí estaba a punto de superar los 21 días después de la aparición del único caso de ébola que había reportado hasta ahora , el de la niña .
El Ministerio de Asuntos Exteriores de Israel negó que impidiera la entrada de la canciller colombiana , María Ángela Holguín , a Palestina y aseguró que fue ella misma colombiana la que decidió suspenderla . canciller holguin Israel aseguró que fue la canciller Holguín quien canceló la visita a Ramala Canciller de Colombia , María Ángela Holguín .	Israel niega haber impedido entrada de canciller Holguín a Palestina Oriente Medio .
El nuevo acuerdo gasífero en discusión contemplará la venta por parte de Rusia de 30.000 millones de metros cúbicos de gas adicionales a China durante 30 años mediante desde depósitos en Siberia Occidental y entregados a través del oleoducto Altai .	El acuerdo suscrito contempla el suministro de gas a China desde los yacimientos de Siberia Occidental con entregas directas para el 2019 .
En una entrevista con The Washington Post , O'Neill aseguró que fue él quién disparó el proyectil que impactó en la frente de Bin Laden .	Algunos miembros del servicio de operaciones especiales y veteranos no están contentos con que uno de los suyos haya reconocido públicamente que fue el autor del disparo que terminó con la vida de Osama Bin Laden .
Sucede que el fundador y patriarca de la Iglesia de los Santos de los Últimos Días construyó parte de su prestigio a partir del amor incondicional y exclusivo que supuestamente dedicó a su mujer .	La Iglesia de Jesucristo de los Santos de los Últimos Días , que oficialmente desaprobó la poligamia a finales del siglo XIX , había intentado por años mostrar a Smith como un leal esposo a su mujer Emma .
Aunque ya existía la tecnología para volver transparentes a los fetos y cerebros adultos de ratón , decolorar a ratones adultos y sus órganos internos con grandes cantidades de sangre había sido difícil .	Sin embargo , este descubrimiento se aplicó a ratones adultos y a órganos con una gran cantidad de sangre .
Testigos informaron además de varios ataques aéreos de la coalición internacional liderada por Estados Unidos contra EI .	Los bombardeos contra sus posiciones por parte de la coalición liderada por Estados Unidos no parecen haberle hecho mella de forma contundente .
El grupo islamista nigeriano Boko Haram ha tomado el control de la localidad nororiental de Chibok , donde el pasado mes de abril secuestró a más de 200 niñas de una escuela .	El grupo islamista nigeriano Boko Haram tomó la ciudad de Chibok , en el noreste de Nigeria , donde hace más de seis meses fueron secuestradas 276 estudiantes , a pesar de las repetidas promesas del gobierno de mandar refuerzos a la zona .
Según las últimas cifras de la Organización Mundial de la Salud , la epidemia de ébola ha dejado hasta el momento casi 5 mil muertos en ocho países , la mayoría en Liberia , Sierra Leona y Guinea , sobre un total de más de 13 mil casos .	Recordó que hay cerca de 3.500 profesionales de la salud de MSF que trabajan ahora en Liberia , Sierra Leona y Guinea , los países más afectados , algunos de los cuales han muerto .
" En casi todos los países encuestados , al menos un tercio de los actuales protestantes fueron criados como católicos y la mitad o más dicen que fueron bautizados " , dice el informe .	En Colombia , por ejemplo , nada menos que el 74% de los declarados protestantes afirman haber sido criados como católicos .
En su intervención , Toyberg-Frandzen dijo que la situación en Donetsk y Lugansk se asimila a la que había antes de los acuerdos de alto el fuego firmados en Minsk el 5 de septiembre pasado por el Gobierno de Ucrania y los rebeldes prorrusos .	En la víspera , la OSCE , encargada de hacer respetar el alto el fuego firmado el 5 de septiembre pasado por los beligerantes y que muchos consideran moribundo , alertó sobre " el nivel de violencia en el este de Ucrania " .
La Iglesia de Jesucristo de los Santos de los Últimos Días ha intentado encubrir aspectos de su historia , como la poligamia practicada por Smith y Brigham Young , quien colaboró en la fundación de la ciudad Salt Lake City , en Utah , donde se ubica la sede central de la institución .	La Iglesia de Jesucristo de los Santos de los Últimos Días , que oficialmente desaprobó la poligamia a finales del siglo XIX , había intentado por años mostrar a Smith como un leal esposo a su mujer Emma .
La corte de Luxemburgo considera que los Estados miembros podrán negar ayudas sociales a los inmigrantes comunitarios que quieran abusar del sistema y no desarrollen ninguna actividad económica ni busquen activamente trabajo .	El Gobierno alemán mostró hoy su satisfacción por la sentencia del Tribunal de Justicia de la Unión Europea que permitirá negar algunas ayudas sociales a ciudadanos comunitarios que no desarrollen ninguna actividad económica ni busquen activamente trabajo .
Los bomberos de Nueva York lograron rescatar a dos trabajadores que limpiaban cristales en la nueva torre del World Trade Center y que se habían quedado colgados hoy en el piso 69 , al desprenderse parte del cableado de su andamio .	Los bomberos de la ciudad acudieron a salvar a dos limpiavidrios atrapados en el piso 68 ; uno de los cables que sostenían la estructura colgante se habría desprendido .
Eso significa que ya no cabe la escusa de … “ perdona es que no me ha llegado ” o “ perdona es que no lo he leído ” .	Ya no sólo te indica si te ha llegado , sino que también si lo has leído .
La ministra para las Relaciones Interiores , Justicia y Paz , Cármen Meléndez , informó este domingo que Leiva Padilla Mendoza , alias “ El Colombia ” , presunto asesino del diputado oficialista Robert Serra , será extraditado desde Colombia en los próximos días .	La BBC señaló que el presunto asesino también murió en un hotel tras recibir una descarga de pistola eléctrica .
El líder palestino acusa a Israel de perpetuar ' guerra religiosa ' en aniversario de la muerte de Yaser Arafat .	La respuesta de Hamas no tardó en llegar : todo esto no son más que " mentiras " , " insultos " y " desinformación " , cuando " el pueblo palestino necesita a un presidente valiente " , diez años después de la muerte de su icono nacional .
Tras varios meses de negociaciones , el portal alcanzó un acuerdo con la agencia de derechos Merlin , que representa a unos 20.000 sellos discográficos independientes de 39 países .	Los sellos discográficos que representan el 95% de la industria de la música ya habían suscrito el acuerdo , pero Merlin , que representa a más de 20.000 compañías de 39 países no lo había hecho .
Los medios en ese país inmediatamente eliminaron un video de Internet , en el que aparece un caballeroso Putin cubriendo los hombros de la primera dama de China , Peng Liyuan , con un abrigo durante la cena de gala de la cumbre .	El Kremlin defendió hoy la galantería del presidente ruso , Vladimir Putin , que puso sobre los hombros de la primera dama china una manta durante la cena de gala de la cumbre del Foro de Cooperación Económica Asia-Pacífico en Pekín .
Aunque con 425 millones de fieles , América Latina contiene el 40% de la población católica del mundo , cada vez son más los cristianos que se dicen protestantes .	América Latina posee más de 425 millones de católicos que representan casi el 40% de la población católica en todo el mundo , pero el número de fieles que busca otra denominación aumenta sostenidamente , en su mayoría en denominaciones protestantes .
Robert O'Neill , el miembro del grupo de fuerzas especiales Navy Seal de Estados Unidos que efectuó el disparo mortal que acabó con la vida de Osama bin Laden en 2011 en Pakistán , reveló más detalles sobre la operación que hasta hace unos días era secreta .	En entrevista para la cadena de noticias CNN , Robert O’Neill , quien fue miembro del grupo élite de fuerzas especiales Navy Seal de Estados Unidos durante 15 años , afirmó que el ex líder de Al Qaeda , Osama Bin Laden , “ murió asustado como una gallina ” .
Una ola de frío del ártico está provocando fuertes nevadas en varias regiones de Canadá y el medio oeste de Estados Unidos .	Una ola de aire polar proveniente de Alaska hizo descender este martes la temperatura en nueve estados del centro y noreste de Estados Unidos , con fuertes nevadas que ya dejaron dos muertos , cientos de vuelos cancelados y más de 700 accidentes viales .
El ministro de Exteriores de Rusia , Serguéi Lavrov , y el secretario de Estado de EEUU , John Kerry , pidieron hoy una reunión urgente entre Ucrania y los separatistas prorrusos , con mediación de Rusia y la OSCE , en Minsk .	Lavrov ha hablado por teléfono con Kerry a iniciativa de éste , según ha informado el Ministerio de Exteriores ruso en un comunicado .
Pero solo se “ sintió realmente libre ” , el 9 de noviembre de 1989 , fecha en la que cayó el muro de Berlín , que hoy Alemania y el mundo entero recuerdan .	El 12 de noviembre de 1989 , Daniel Barenboim dirigía en Berlín un concierto con música de Beethoven .
Bissonnette aseguró en su libro " No Easy Day " , publicado en 2012 , que fueron otros dos Navy Seal los que remataron a Bin Laden cuando ya estaba herido de muerte en el suelo .	Sin embargo , en su libro No Easy Day , publicado en 2012 , Matt Bissonnette -uno de los tres Navy Seals- señaló que él también disparó , pero que fue el primer comando el que mató a Bin Laden .
Williams había salido de la cárcel dos semanas antes , tras haber cumplido una condena de cinco años por atacar violentamente a su ex pareja .	Matthew Williams , de 34 años , había sido liberado hace apenas dos semanas después de cumplir una larga condena de cinco años en prisión por delitos de violencia .
Mientras tanto , el secretario de Estado estadounidense John Kerry se reunía con su homólogo iraní , Mohamad Javad Zarif , en el marco de unas conversaciones lideradas por la representante de la Unión Europea Catherine Ashton .	Mohammad Javad Zarif sostendrá conversaciones con el secretario de Estado de Estados Unidos , John Kerry , y con la enviada de la Unión Europea , Catherine Ashton , en Omán el domingo para tratar de salvar brechas antes de que se reanuden las negociaciones en Viena el 18 de noviembre .
La sentencia se basa en la directiva comunitaria sobre el derecho de circulación y residencia , que condiciona el derecho de residencia al ejercicio una actividad económica o a disponer de recursos suficientes .	Cuando el período de residencia es superior a tres meses pero inferior a cinco años , la norma condiciona el derecho de residencia a que las personas que no ejercen una actividad económica dispongan de recursos propios suficientes .
El insurgente agregó que durante la noche las tropas ucranianas cañonearon varias zonas residenciales de Donetsk , donde dos adolescentes murieron el miércoles en un ataque contra el campo de fútbol de una escuela local .	Dos adolescentes murieron ayer y otros cuatro resultaron heridos por fuego de artillería en el campo de fútbol de una escuela de la misma localidad .
Esta ciudad es la capital comercial de Yobe , que junto con Borno y Adawama son las tres provincias norteñas en las que permanece en vigor el estado de emergencia decretado por el Gobierno de Nigeria desde mayo de 2013 , debido a la violencia de Boko Haram .	El grupo terrorista ha continuado perpetrando secuestros y atentados , la mayoría centrados en los Estados norteños de Borno , Adawama y Yobe , que llevan en estado de emergencia desde mayo de 2013 .
El Papa Francisco ha tenido un nuevo gesto para con quienes menos tienen : ordenó construir duchas en los baños ubicados a un lado de la Plaza de San Pedro , para que sean utilizadas por los vagabundos que circundan el Vaticano , publica la agencia Notimex .	El papa Francisco ha mandado instalar tres duchas en el interior de los baños que hay bajo las columnas de la basílica de San Pedro para que puedan lavarse y cambiarse los sin techo que duermen en los alrededores del Vaticano .
La aeronave intentaba aterrizar el domingo en la isla de Gran Bahama , hasta el momento se desconoce la causa del accidente .	Una avioneta se estrelló mientras intentaba aterrizar el domingo en la isla de Gran Bahama y las nueve personas a bordo murieron , informaron autoridades de Bahamas .
El anuncio se produjo solo un día después de que las autoridades sanitarias del país dijesen que no se habían registrado más casos -mucho menos fallecidos- luego de que una niña de dos años que viajó al país procedente de Guinea falleciese a causa del virus a finales de octubre .	El gobierno del estado de Chhattisgarh suspendió la campaña de esterilización , ordenó una investigación sobre la muerte de las mujeres que se sometieron a la cirugía y denunció a cuatro médicos .
Según la acusación del Ministerio Público , que acogió la corte , el religioso aprovechándose de su condición de guía espiritual del establecimiento educativo sustraía constantemente de la sala de clases a una de las niñas para cometer los abusos entre los años 2007 y 2012 .	Diez años después el sacerdote fue acusado por los padres de dos alumnas de aprovecharse de su condición de guía espiritual del establecimiento para sustraerlas constantemente de la sala de clases y abusar sexualmente de ellas .
Malí registró su primer caso con la muerte de una niña de dos años el 24 de octubre en Kayes , que viajó con su abuela desde el sur de la vecina Guinea , donde se declaró la epidemia en diciembre de 2013 .	" En el caso de que los acontecimientos sean contrarios al acuerdo de Minsk , las Fuerzas Armadas están capacitadas y preparadas para repeler " , ha dicho Poroshenko , en un comunicado difundido por la Presidencia ucraniana .
El prófugo abogado Rodolfo Orellana fue capturado este jueves en la ciudad de Cali , Colombia , más de 130 días después de que el Poder Judicial ordenara su detención preventiva .	Su hermana Ludith fue detenida también este jueves , pero en la ciudad de Huaral , al norte de Lima .
¿ Por qué el hombre que mató a Osama Bin Laden salió a la luz ?	Pero ahora ya se conoce quién fue el que mató a Bin Laden , el líder de Al Qaeda y el enemigo por antonomasia de los Estados Unidos .
El presidente de Perú , Ollanta Humala , abordará hoy con el líder ruso , Vladímir Putin , la construcción de una central nuclear en el país latinoamericano , informó un portavoz del Kremlin .	El presidente de Perú , Ollanta Humala , tiene previsto iniciar hoy una gira que le llevará primero a Rusia , donde se entrevistará el viernes con el presidente ruso , Vladimir Putin , y después a China y El Vaticano en un viaje que concluirá el día 16 .
Un equipo de científicos japoneses ha logrado crear ratones transparentes lo que , según explican , permite observar sus órganos y estudiar la evolución de enfermedades como el cáncer o la diabetes sin la necesidad de diseccionar .	Un grupo de científicos logra hacer transparentes a ratones para estudiar el cáncer .
El papa Francisco ordenó la construcción de tres duchas en los tres baños que hay bajo las columnas de la basílica del Vaticano .	El papa Francisco ha mandado instalar tres duchas en el interior de los baños que hay bajo las columnas de la basílica de San Pedro para que puedan lavarse y cambiarse los sin techo que duermen en los alrededores del Vaticano .
Sicarios han declarado que asesinaron a los muchachos e incineraron sus cuerpos durante 14 horas en un basurero de la localidad de Cocula , vecina de Iguala , y después arrojaron los restos en bolsas a un río .	Los sicarios detenidos dijeron que en ese basurero quemaron los cuerpos de los estudiantes y que luego arrojaron sus restos al río .
Desde Roma , el jefe de Estado reveló que desde hace 45 días " se sabía que Orellana estaba fuera del país " , y que por esa razón un equipo de la Dirección Antidrogas del Perú viajó a Colombia , luego de conocer que el abogado , investigado por el caso " La Centralita " , había fugado vía Ecuador .	Desde Roma , donde se reunirá mañana con el Papa Francisco , Humala Tasso indicó que hace 45 días un equipo de la Dirección Antidrogas de la Policía Nacional se trasladó a Cali , tras tener información que indicaba que ‘ El Gordo ’ había salido del Perú hacia Ecuador y luego a Colombia .
Además , instó a los extremistas de Marruecos , Argelia , Túnez y Libia a " combatir a los laicos " .	Al Bagdadi se refiere también a los eventos de los últimos días y llama a su seguidores a mantener la lucha contra los “ cruzados ” .
Otra colaboración no menos importante fue la de Edgar Téllez , el editor de Planeta que es una autoridad en la historia del narcotráfico en Colombia , lo que le permitió a Juan Pablo-Sebastián complementar la visión familiar de los hechos con un panorama macro del mundo de la droga .	En términos generales el libro combina un recuento bien hecho de la historia del narcotráfico en Colombia con el drama de la familia que la protagonizó .
Un total de 83 mujeres , todas menores de 32 años , pobres y de zonas rurales , fueron operadas el sábado en un hospital a las afueras de la ciudad de Bilaspur , en el estado central de Chhattisgarh , según los funcionarios .	Las mujeres que se sometieron a la cirugía el sábado recibieron un pago de 10 dólares cada una , y las 83 fueron operadas en cuestión de seis horas , dijo el director médico del estado , el doctor S.K. Mandal a The Associated Press por teléfono .
Ismael Zambada Imperial , alias “ El Mayito Gordo ” o “ El Mayo Gordo ” , hijo del capo Ismael “ El Mayo ” Zambada , fue capturado ayer por elementos de la Marina en El Salado , Sinaloa , junto con dos presuntos cómplices .	El hijo del capo fue aprehendido el miércoles en el poblado La Estancia de los Burgos , perteneciente a la sindicatura de El Salado , municipio de Culiacán Ismael Zambada Imperial , conocido como El Mayito Gordo , hijo del Mayo Zambada , fue detenido el miércoles por elementos del Ejército Mexicano en Sinaloa .
La cadena estadounidense Fox News se ha volcado con esta causa y esta noche ofrece un programa especial llamado ‘ El Hombre que mató a Osama Bin Laden ’ que tendrá dos entregas : la de esta noche y la de mañana .	Robert James O'Neill es el hombre que aparentemente mató a Osama bin Laden en Abbotabad el 1 de mayo de 2011 .
De acuerdo con la autopsia realizada al actor Robin Williams , se indica que padecía delirios , no sólo sufría depresión , ansiedad , sino demencia con cuerpos de Lewy , que se presenta en muchos casos de Parkinson .	Y es que gracias a la información facilitada por TMZ , el genial actor al que podremos ver postumamente en ‘ Noche en el Museo 3‘,no solo padecía una fuerte depresión acompañada de ansiedad y parkinson en el momento de fallecer , ya que se ha detectado que también padecía una dolencia llamada demencia de cuerpos de Lewy , que en muchos casos se asocia al problemática parkinson .
Sin embargo desde Kiev se negó que esté en marcha una nueva ofensiva militar en el este del país .	Nos atacan y nosotros nos defendemos " , ha asegurado Andréi Purguín , viceprimer ministro de la autoproclamada república popular de Donetsk , a la agencia oficial rusa RIA-Nóvosti .
" Un Estado miembro debe contar con la posibilidad de denegar las prestaciones sociales a ciudadanos de la Unión que no desarrollen una actividad económica y que ejerzan su libertad de circulación con el único objetivo de percibir la ayuda social de otro Estado miembro cuando no disponen de recursos suficientes para optar al derecho de residencia " , asegura el fallo difundido este martes .	Garantizar la subsistencia Dice el fallo : " La directiva pretende impedir de ese modo que los ciudadanos de la Unión que no ejerzan una actividad económica utilicen el sistema asistencial del Estado miembro de acogida para garantizar su subsistencia " .
En el caso de que la Audiencia decidiera de nuevo que se puede llevar adelante la acusación , la infanta iría a juicio .	Aun así , Roca ha destacado la importancia de que la Audiencia haya estimado que no existen delitos de blanqueos de capitales , la causa más grave a la que se enfrentaba la infanta Cristina .
La noticia , fue confirmada por fuentes cercanas a la familia , según lo señaló el portal TMZ .	Fuentes vinculadas a la familia confirmaron el diagnóstico al portal de noticias TMZ , medio que accedió a un informe en el que se señalaba que el actor padecía dicha condición .
Tras conocer esta situación , el papa argentino autorizó la construcción de las tres duchas en el interior de los baños que normalmente usan los peregrinos , y que comenzarán a instalarse el próximo 17 de noviembre .	Serán colocadas en el interior de los baños que hay bajo las columnas de la basílica de San Pedro .
El pasado miércoles , el secretario de Estado se encontró en París con el ministro francés de Exteriores , Laurent Fabius , para explicarle los detalles de su plan .	El secretario de Estado de Estados Unidos , John Kerry inició este domingo en Omán una reunión con el ministro de Relaciones exteriores iraní , Mohammad Javad Zarif para lograr avances sobre el programa nuclear que desarrolla Teherán .
Las Autoridades pidieron a los vecinos no salir de casa hasta que el felino sea atrapado .	Un tigre se escapó y merodea las inmediaciones del parque de Disneyland en París y las autoridades ordenaron a los habitantes de tres poblaciones que no salgan de sus casas .
Los gobiernos de China y Japón reconocen que " existen diferentes posiciones entre ellos " respecto a la soberanía de islas ubicadas en el este del Mar de China , conocidas como Senkaku en Japón y Diaoyu en China .	Los comunicados indicaron que China y Japón también " reconocieron que existen posiciones diferentes entre ellos " sobre las tensiones por las islas en el Mar de China Meridional y acordaron establecer un mecanismo de manejo de crisis para evitar " contingencias " .
Ya puedes saber si un contacto de los que tienes en agenda ha leído tus mensajes y viceversa .	Además de saber si un destinario ha leído o no tus mensajes , ahora también es posible conocer , en grupo , que usuario lo han hecho y cuáles no .
Equipos de emergencias han rescatado a dos trabajadores que se quedaron colgados en un andamio en el piso 69 de la torre 1 del World Trade Center , construido sobre los restos de las Torres Gemelas destruidas en los atentados del 11 de septiembre . o Más lo más 50 Comentado	Y por ser el sucesor de las Torres Gemelas , se convirtió en un símbolo de la recuperación de Nueva York -y de Estados Unidos- tras los atentados terroristas del 11 de Septiembre .
La lava del volcán Kilauea , situado en la “ Isla Grande ” de Hawaii , Estados Unidos , destruyó la primera vivienda en el pueblo de Pahoa , amenazando a otros cincuenta hogares , informaron las autoridades locales .	El río de lava del volcán Kilauea , que avanza lentamente hacia la localidad de Pahoa , en la Isla Grande del estado de Hawái , ha reducido a cenizas la primera vivienda que se encontraba bajo amenaza y que había sido previamente desalojada , según han informado funcionarios de Defensa Civil .
La demencia de cuerpos de Lewy provoca síntomas como alucinaciones , problemas de atención y dificultades para reconocer a amigos y familiares , reportó el portal .	La demencia de cuerpos de Lewy se produce debido a la acumulación anormal de proteínas en el cerebro .
Las emocionantes imágenes de la gente agolpándose en Berlín en noviembre de 1989 tras la caída del Muro tienen una banda sonora : la música de Beethoven , que este domingo sonará en la Puerta de Brandeburgo .	Miles de personas se reunirán en torno al símbolo de la unidad alemana , la Puerta de Brandeburgo en Berlín .
Ayer , algunos activistas y estudiantes se movilizaron para tratar de averiguar cuántas personas habrían sido detenidas la víspera , debido a los hechos vandálicos que se dieron luego de una manifestación que transcurrió de forma pacífica de la sede de la Procuraduría General de la República al Zócalo capitalino para demandar una vez más justicia por el caso de los 43 normalistas de Ayotzinapa que permanecen desaparecidos desde el pasado 26 de septiembre .	Los disturbios se han registrado al finalizar una multitudinaria marcha que había partido desde la instalaciones de la Procuraduría General de la República hasta el Zócalo de la capital mexicana para exigir el retorno con vida de los 43 estudiantes desaparecidos en septiembre .
La lava del volcán Kilauea , en la isla grande de Hawaii , quema la primera vivienda .	Se trató de la primera casa reducida a cenizas por el flujo de lava que brota del volcán Kilauea , en la Gran Isla , y del que los científicos han alertado a los residentes desde agosto .
En el ataque , perpetrado este lunes , al menos 48 personas -en su mayoría estudiantes- murieron y otras 79 resultaron heridas en una escuela de secundaria en la localidad de Potiskum , en el noreste de Nigeria .	El ataque suicida provocó el caos , obligando a cerrar la mayoría de escuelas de la localidad de Potiskum .
La mandataria , de 61 años , “ retomó ayer de manera incipiente la agenda gubernamental ” en la residencia presidencial de Olivos , en las afueras de la ciudad de Buenos Aires , informó el ministro coordinador .	" La Presidenta de la Nación ha retomado ayer de una manera incipiente la agenda gubernamental , hecho que es muy trascendente " , informó el jefe de Gabinete esta mañana , en su habitual encuentro con periodistas , aunque aclaró que " obviamente , en el marco de la prescripción médica de reposo " .
Malí registró su primer caso con la muerte de una niña de dos años el 24 de octubre en Kayes , que viajó con su abuela desde el sur de la vecina Guinea , donde se declaró la epidemia en diciembre de 2013 .	En el caso de la joven de 14 años , Helen Mar Kimball , hija de un amigo cercano de Joseph Smith , el matrimonio fue solo para la eternidad con lo que , según dice el ensayo , que apunta que en esa época era legal casarse con chicas de esa edad , no habría implicado relaciones sexuales .
“ Vimos columnas de equipamiento ruso , tanques rusos , sistemas de defensa antiaérea rusos , artillería rusa y tropas de combate rusas entrar en Ucrania ” , declaró Breedlove .	La OSCE y la OTAN han constatado la entrada en el este de Ucrania desde territorio ruso de equipamiento , tanques , artillería , sistemas de defensa antiaérea e incluso tropas en ayuda de las milicias separatistas .
El problema ocurrió en el lado sur del One World Trade Center , el rascacielos más alto de Estados Unidos .	Los trabajadores estaban pendiendo del piso 68 en el exterior del edificio del One World Trade Center .
Entretanto , Hagel indicó que la coalición liderada por Estados Unidos está registrando un “ avance constante y sostenible ” en su combate contra los militantes de EI en Irak y Siria , pero advirtió que “ será una lucha larga y difícil ” . “ Habrá reveses .	En la grabación , el presunto líder del ISIS declara que la coalición internacional liderada por Washington está fracasando en su lucha contra los yihadistas .
Los firmantes han indicado que " todas estas graves denuncias se producen a menos de un año de que entrara en vigor la Ley Especial para Prevenir y Sancionar la Tortura y otros Tratos o Penas Crueles , Inhumanos o Degradantes en Venezuela " .	Así , han exhortado a Venezuela " a extender una invitación al relator de la ONU contra la Tortura y a ratificar el Protocolo Facultativo de la Convención contra la Tortura y Otros Tratos o Penas Crueles , Inhumanos o Degradantes " .
Los doctores Marcelo Ballesteros y Daniel Fernández señalaron que la gobernante “ continúa con tratamiento antibiótico , dieta especial , reposo y control evolutivo ” en la residencia presidencial de Olivos , a las afueras de Buenos Aires .	El parte médico , firmado por los doctores Marcelo Ballesteros y Daniel Fernández , señala que la mandataria " cumple un tratamiento sintomático y antibiótico " en el sanatorio privado Otamendi de la capital argentina .
Esta funcionaria jubilada de la RDA confiesa , 25 años después de la caída del Muro , que fue feliz en la RDA .	La caída del muro fue parte del colapso generalizado del comunismo en la Europa del Este .
