El archipiélago de Puerto Rico incluye la isla principal de Puerto Rico , la más pequeña de las Antillas Mayores , y un número de cayos e islas más pequeñas , de las cuales las más grandes son : Mona , Vieques y Culebra .	La Economía de Puerto Rico es la más competitiva y , en términos nominales , la más grande de la región Centroamericana y del Caribe .
Para la mayoría de las denominaciones cristianas , es el Hijo de Dios y , por extensión , la encarnación de Dios mismo .	Jesús no es Dios sino el Hijo de Dios y uno con Dios en « calidad y no en cantidad » .
Las " partículas elementales " son los constituyentes elementales de la materia , más precisamente son partículas que no están constituidas por partículas más pequeñas ni se conoce que tengan estructura interna .	Actualmente el nombre partícula elemental se usa para las partículas que , hasta donde se sabe , no están formadas por partículas más simples .
Su capital es la ciudad de San Salvador , y las ciudades de Santa Ana y San Miguel son también importantes centros urbanos del país .	Por otro lado , es la zona más densamente poblada del país , ya que allí se asientan importantes ciudades como lo son San Salvador , Santa Ana , y San Miguel .
La " universidad de Uppsala " ( en sueco : " Uppsala universitet " ) es una universidad ubicada en la ciudad de Uppsala , Suecia , y es la casa de estudios más antigua de Escandinavia , habiendo sido fundada en 1477 .	La Universidad de Uppsala constantemente es considerada como una de las universidades más prestigiosas de Europa y del país .
" Blade Runner " es una película de ciencia ficción estadounidense , dirigida por Ridley Scott , estrenada en 1982 y basada parcialmente en la novela de Philip K. Dick " ¿ Sueñan los androides con ovejas eléctricas ? " ( 1968 ) .	Hay tres novelas oficiales y autorizadas de " Blade Runner " , escritas por el amigo de Philip K. Dick , K. W. Jeter , que continúan la historia de Rick Deckard e intentan resolver las diferencias entre " Blade Runner " y " ¿ Sueñan los androides con ovejas eléctricas ? " .
" América del Sur " o " Sudamérica " , también llamada " Suramérica " , es el subcontinente austral de América .	Portugal se apropió de la mayor parte de la franja costera atlántica de la parte norte de América del Sur , que más tarde originaría el Estado de Brasil .
" La Antropología es el estudio de la realidad humana , es la Ciencia que trata de los aspectos biológicos y sociales del hombre " .	La antropología es , sobre todo , una ciencia integradora que estudia al hombre en el marco de la sociedad y cultura a las que pertenece , y , al mismo tiempo , como producto de éstas .
El " escudo de España " es el símbolo heráldico que representa al Reino de España .	El gobierno federal representa a los Estados Unidos Mexicanos y está dividido en tres ramas : ejecutivo , legislativo y judicial , de acuerdo a lo establecido por la Constitución Política de los Estados Unidos Mexicanos , publicada en 1917 .
El " sistema nervioso central " ( SNC ) es una estructura biológica que sólo se encuentra en individuos del reino animal .	Y se puede decir que el sistema nervioso central es uno de los más importantes de todos los sistemas que se encuentran en dichos cuerpos .
Un " ideograma " es un icono , imagen convencional o símbolo , que representa un ser , relación abstracta o ideas , pero no palabras o frases que los signifiquen , aunque en la escritura de ciertas lenguas significa una palabra , morfema o frase determinados , sin representar cada una de sus sílabas o fonemas .	El concepto de ideograma hace referencia a una imagen o símbolo convencional que sirve para representar un ser o una idea sin necesidad de apelar a palabras o a frases que lo expliquen .
Un compilador es un programa que permite traducir el código fuente de un programa en lenguaje de alto nivel , a otro lenguaje de nivel inferior ( típicamente lenguaje de máquina ) .	En el caso particular de que el lenguaje a traducir es un lenguaje de alto nivel y el lenguaje traducido de bajo nivel , se emplea el término compilador .
La mayoría de las fuentes cita como fecha de fundación de la ciudad el 26 de julio de 1325 , de acuerdo con la información proporcionada por los mexicas y que se encuentra registrada en varios documentos .	Usaban la raíz de coplaxócotl ( " Saponaria americana " ) como jabón , y la raíz de metl para el lavado de la ropa .
Un " texto " es una composición de signos codificado en un sistema de escritura ( como un alfabeto ) que forma una unidad de sentido .	También es texto una composición de caracteres imprimibles ( con grafema ) generados por un algoritmo de cifrado que , aunque no tienen sentido para cualquier persona , sí puede ser descifrado por su destinatario original .
La " enfermedad de las vacas locas " , o " encefalopatía espongiforme bovina " , es una enfermedad causada por priones , y que se puede transmitir a los seres humanos a través del consumo de partes de animales infectados , sobre todo tejidos nerviosos .	La encefalopatía espongiforme bovina ( EEB ) o « enfermedad de las vacas locas » es una enfermedad de reciente aparición , perteneciente a una misteriosa familia de enfermedades emparentadas , muy raras en su mayoría .
Hombre de acción , estadista y diplomático , fue uno de los caudillos de la rebelión de los judíos contra los romanos .	En el año 64 se trasladaría a Roma para conseguir de Nerón la liberación de algunos sacerdotes judíos amigos suyos capturados durante las revueltas judías contra los romanos , causa por la que es procesado y encarcelado .
" Honduras " es un país de América , ubicado en el extremo norte de América Central .	Bagdad posee un clima muy caluroso y árido ( " BWh " , según la tabla de Köppen ) , siendo una de las ciudades más calurosas del mundo .
El " quechua " o " quichua " es una familia de lenguas originaria de los Andes centrales que se extiende por la parte occidental de Sudamérica a través de siete países .	El quechua habría tenido su origen en una lengua de la región central y occidental del Perú .
Como en la economía de todos los países europeos , el sector terciario o sector servicios es el que tiene un mayor peso .	De los crustáceos , la gamba , y de los moluscos el calamar y el pulpo .
El " Departamento de Oruro " es un departamento de Bolivia ubicado al oeste del país .	La " acalasia " consiste en la incapacidad para relajar las fibras de músculo liso del aparato gastrointestinal en cualquier sitio de unión de una parte con otra .
Cuando un electrón colisiona con un positrón , las dos partículas pueden resultar totalmente aniquiladas y producir fotones de rayos gamma .	Si el electrón y el positrón tienen una cantidad de movimiento despreciable se puede formar un positronio antes de que la aniquilación resulte en dos o tres fotones de rayos gamma de un total de 1.022 MeV.
La representación de " coma fija " es una forma de notación científica que consiste en destinar una cantidad fija de dígitos para la parte entera y otra para la parte fraccionaria .	En los anteriores ejemplos la coma está fija y sirve para separar la parte entera de la parte fraccionaria .
La superficie de Colombia es de 2.129.748 km² , de los cuales 1.141.748 km² corresponden a su territorio continental y los restantes 988.000 km² a su extensión marítima ,	Colombia es el vigésimo sexto país más grande del mundo y el cuarto en América del Sur con 1.141.748 km² que corresponden a su territorio continental y 988.000 km² a su extensión marítima , para una superficie total de 2.129.748 km² .
La " Expropiación Petrolera " , es el resultado de la implementación de la Ley de Expropiación de 1936 y del Artículo 27 de la Constitución Mexicana aplicados a las compañías petroleras el 18 de marzo de 1938 , por el Presidente de la República , el general Lázaro Cárdenas del Río .	Otros alcanos conocidos son el etano , propano y el butano con dos , tres y cuatro átomos de carbono respectivamente .
El " periodismo " es una actividad que consiste en recolectar , sintetizar , jerarquizar y publicar información relativa a algo de la actualidad .	El periodismo ciudadano es aquel que consiste en que son los ciudadanos y no los periodistas o empresas informativas , quienes recogen , analizan y difunden la información de forma independiente .
La " Historia de América " es la historia colectiva de los pueblos del continente americano , incluidas las Antillas y demás islas próximas .	" La Prehistoria de América es objeto de permanente estudio dadas las muchas " preguntas que permanecen sin respuestas contundentes , como las teorías del poblamiento y la historia y el desarrollo de muchos pueblos americanos aborígenes .
Un " orbital atómico " es una determinada función de onda , espacial e independiente del tiempo a la ecuación de Schrödinger para el caso de un electrón sometido a un potencial coulombiano .	Cualquier paquete de datos enviado por cualquier máquina es recibido por todas las de la red .
A lo largo de su historia , los pueblos mesoamericanos construyeron una civilización cuyas expresiones hablan de elementos compartidos por varios pueblos y rasgos que los distinguen entre sí .	Todos los pueblos mesoamericanos tuvieron una divinidad del maíz , y estuvo presente desde tiempos de los olmecas .
Su comienzo se sitúa convencionalmente en el año 476 con la caída del Imperio romano de Occidente y su fin en 1492 con el descubrimiento de América , o en 1453 con la caída del Imperio bizantino , fecha que tiene la ventaja de coincidir con la invención de la imprenta " ( Biblia de Gutenberg ) " y con el fin de la Guerra de los Cien Años .	Apareció el parlamentarismo , una forma de representación política que con el tiempo se convirtió en el precedente de la división de poderes consustancial a la democracia de la Edad Contemporánea .
El castellano o español , idioma oficial en todo el país , es la lengua materna predominante en casi todas las comunidades autónomas de España .	El español o castellano es el único idioma oficial de todo el país y es el hablado como lengua habitual y materna por la gran mayoría de la población española .
La " unidad astronómica " ( abreviada " ua " , " au " , " UA " o " AU " ) es una unidad de longitud igual por definición a 149.597.870.700 metros ,	En la asamblea general de la Unión Astronómica Internacional de agosto de 2012 en Pekín se resolvió dejar sin efecto la definición gaussiana y darle a la unidad astronómica el valor actual de 149.597.870.700 metros .
Las arqueas , como las bacterias , son procariotas ; en este sistema , presentado por Carl Woese , las tres ramas evolutivas principales son las arqueas , las bacterias y los eucariotas .	Las arqueas fueron clasificados por primera vez como un superreino separado de las bacterias en 1977 por Carl Woese y George E. Fox en árboles filogenéticos basados en las secuencias de genes de ARN ribosómico ( ARNr ) .
" Gladiolus " y " Moraea " son géneros muy amplios y componentes principales de la flora sub-Saharana y sudafricana .	" Moraea " y " Homeria " son dos géneros de plantas venenosas y representan un problema en las regiones productoras de ovinos y bovinos , notablemente en Sudáfrica .
Es uno de los países de mayor diversidad biológica del mundo y de mayores recursos minerales .	El historial peruano en los Juegos Olímpicos es muy escaso ; pese a ello , es uno de los primeros países sudamericanos en ganar una medalla de oro en los Juegos Olímpicos .
La " densidad media " es la razón entre la masa de un cuerpo y el volumen que ocupa .	Para la obtención indirecta de la densidad , se miden la masa y el volumen por separado y posteriormente se calcula la densidad .
En geometría euclidiana , un " cuadrado " es un paralelogramo que tiene sus lados iguales y además sus cuatro ángulos son iguales y rectos , tiene 4 ejes de simetría , 4 vértices y 4 aristas .	Dado que sus cuatro ángulos internos son rectos , es también un caso especial de rectángulo , es un rectángulo equilátero .
Para la mayoría de las denominaciones cristianas , es el Hijo de Dios y , por extensión , la encarnación de Dios mismo .	Por la muerte de Cristo , se supera el pecado y por su resurrección , la muerte .
" La Antropología es el estudio de la realidad humana , es la Ciencia que trata de los aspectos biológicos y sociales del hombre " .	La Antropología biológica o física es el campo de la Antropología que se especializa en el estudio de los seres humanos desde el punto de vista evolutivo y adaptativo .
La " Región de Los Lagos " es una de las quince regiones en las que se encuentra dividido Chile .	« La Región de los Lagos » es una región de Chile creada en 1974 , mediante el Decreto Ley Nº 575 ; en un proceso denominado de regionalización .
La mayor parte de su población se concentra en la parte sur de la provincia .	La mayor parte de sus MAL ( Miembros de la Asamblea Legislativa ) representaban a pequeños pueblos y predios rurales .
Una división de la malacología , la conquiliología , se encarga del estudio de los moluscos con concha .	La malacología contribuye al conocimiento y estudio de la biodiversidad , por medio de inventarios de ejemplares de moluscos y el estudio de los mismos .
El País Vasco está reconocido como nacionalidad histórica por su Estatuto de Autonomía y por la Constitución española .	El País Vasco accedió a su autonomía con la aprobación del Estatuto de Autonomía en 1979 .
Como resultado , en 1927 el nombre formal del Reino Unido de la Gran Bretaña e Irlanda cambió a su nombre actual , el Reino Unido de Gran Bretaña e Irlanda del Norte .	La " Prelatura de la Santa Cruz y Opus Dei " es una institución perteneciente a la Iglesia católica .
Geográficamente , la provincia se compone de la isla de Terranova y la Península del Labrador , en la costa atlántica .	La producción lechera es también otra gran parte de la industria agrícola de Terranova .
La Grecia moderna tiene su origen en la civilización de la antigua Grecia , considerada la cuna de la civilización occidental .	La primera poesía lírica , la representativa por poetas como Safo y Píndaro , fue la responsable de la definición del género lírico como es entendido en la actualidad en la literatura occidental .
El gobierno federal representa a los Estados Unidos Mexicanos y está dividido en tres ramas : ejecutivo , legislativo y judicial , de acuerdo a lo establecido por la Constitución Política de los Estados Unidos Mexicanos , publicada en 1917 .	El " Consejo de Seguridad de Naciones Unidas " es el organismo de las Naciones Unidas encargado de mantener la paz y seguridad entre las naciones .
" San Juan de Torres " es una localidad del municipio de Cebrones del Río , situado en el sur de la provincia de León , España .	El pueblo también es paso por una de las antiguas rutas de la Vía de la Plata .
La neuroanatomía es el estudio de la estructura y la organización del sistema nervioso .	La estructura de la médula espinal está compuesta en su porción céntrica por la " sustancia gris " , y en su periferia por la " sustancia blanca " .
Ejemplos conocidos son la cocaína , la morfina , la atropina , la colchicina , la quinina , cafeína , la estricnina y la nicotina .	Ejemplos de betaínas son la betaína glicínica , la trimetilserina ( precursor de la colina ) y la hipaforina .
" Winslow Homer " ( 24 de febrero de 1836 - 29 de septiembre de 1910 ) fue un pintor naturalista estadounidense , considerado junto con Thomas Eakins como uno de los más grandes artistas de su país en el siglo XIX .	Homer nació en Boston el 24 de febrero de 1836 y su formación como pintor fue , en su mayor parte , autodidacta .
Además , el encéfalo y la médula espinal están protegidos por envolturas óseas , que son el cráneo y la columna vertebral respectivamente .	Las cavidades de estos órganos ( ventrículos en el caso del encéfalo y conducto ependimario en el caso de la médula espinal ) están llenas de un líquido incoloro y transparente , que recibe el nombre de líquido cefalorraquídeo .
La " parapsicología " es una pseudociencia que estudia los fenómenos paranormales o fenómenos psi ( como la percepción extrasensorial , telequinesia , telepatía , precognición , clarividencia , las experiencias extracorpóreas , el espiritismo y los poltergeist ) .	La parapsicología es considerada una pseudociencia por la comunidad científica , dado que la propia existencia de los fenómenos paranormales no es demostrable científicamente .
El " espín " ( del inglés " spin " ' giro , girar ' ) o " momento angular intrínseco " se refiere a una propiedad física de las partículas subatómicas , por la cual toda partícula elemental tiene un momento angular intrínseco de valor fijo .	Pronto , el concepto de espín se amplió a todas las partículas subatómicas , incluidos los protones , los neutrones y las antipartículas .
La " hora " es una unidad de tiempo que se corresponde con la vigésimo-cuarta parte de un día solar medio .	La hora es también una medida angular : como la Tierra da una vuelta sobre sí misma en aproximadamente 24 horas , una hora equivale a 15º ( o sea , la veinticuatrena parte de la circunferencia ) .
" Morelia " ( de 1545 a 1828 , " Valladolid " ) es una ciudad mexicana , capital del estado de Michoacán de Ocampo y cabecera del municipio homónimo .	Morelia es la ciudad más poblada y extensa del estado de Michoacán con una población de 597.897 en el año 2010 ( 608.049 habitantes en el 2005 ) .
Según una definición clásica , " fuerza " es todo agente capaz de modificar la cantidad de movimiento o la forma de los materiales .	En este sentido la fuerza puede definirse como toda acción o influencia capaz de modificar el estado de movimiento o de reposo de un cuerpo ( imprimiéndole una aceleración que modifica el módulo o la dirección de su velocidad ) .
La magnitud del peso de un objeto , desde la definición operacional de peso , depende tan sólo de la intensidad del campo gravitatorio local y de la masa del cuerpo , en un sentido estricto .	Hemingway escribió la mayor parte de su obra entre mediados de 1920 y mediados de 1950 .
Los órganos sexuales de otros grupos de animales , por ejemplo , de los nematoda también pueden ser denominados análogamente como « vulva » , sin embargo se diferencian por completo de la vulva de los mamíferos .	Por regla general , se denomina vulva únicamente a los órganos sexuales femeninos externos de los mamíferos , aunque en la literatura científica la denominación se utiliza también para estructuras funcionalmente comparables o análogas de otros grupos de animales , como por ejemplo en los gusanos redondos " ( Nematoda ) " .
El " sistema astronómico de unidades " , llamado formalmente « Sistema de constantes astronómicas de la IAU ( 1976 ) » ( en inglés , " IAU ( 1976 ) System of Astronomical Constants " , es un sistema de unidades desarrollado para su uso en astronomía .	El sistema de unidades astronómico es un sistema tridimensional , en el que están definidas las unidades de longitud , masa y tiempo .
La " Antártida " o " continente antártico " , es el continente sobre el cual se encuentra el Polo Sur .	Limita con los departamentos de Cajamarca al oeste , con La Libertad y San Martín al sur , con Loreto al este y al norte con la república de Ecuador .
Se cree que África es la cuna de la Humanidad y de allí proceden las sucesivas especies de homínidos y antropoides que dieron lugar a los seres humanos .	En África las características de la población y su esperanza de vida varían según las condiciones .
La " heráldica " es la ciencia del blasón ( « blasón » , según la RAE se define como el « arte de explicar y describir los escudos de armas de cada linaje , ciudad o persona » ) .	La heráldica es esencialmente la ciencia de los heraldos , y su origen no puede comprenderse sino a través de su rol .
Las subculturas se definen a menudo por su oposición a los valores de la cultura dominante a la que pertenecen , aunque esta definición no es universalmente aceptada , ya que no siempre se produce una oposición entre la subcultura y la cultura de una manera radical .	Si la subcultura se caracteriza por una oposición sistemática a la cultura dominante , entonces puede ser descrita como una contracultura .
En el uso coloquial , a los lípidos se les llama incorrectamente " grasas " , ya que las grasas son sólo un tipo de lípidos procedentes de animales .	A los lípidos complejos también se les llama " lípidos de membrana " pues son las principales moléculas que forman las membranas celulares .
La teoría de la información es una rama de la teoría matemática y de las ciencias de la computación que estudia la información y todo lo relacionado con ella : canales , compresión de datos y criptografía , entre otros .	La información es tratada como magnitud física , caracterizando la información de una secuencia de símbolos utilizando la entropía .
En el caso que no existan o no se detecten los módulos , la mayoría de tarjetas madres emiten una serie de pitidos que indican la ausencia de memoria principal .	Por esta razón la lógica se considera una ciencia formal , como la matemática , en vez de una ciencia empírica .
La " Congregación Cristiana de los Testigos de Jehová " ( más conocida por el nombre de sus integrantes : " Testigos de Jehová " ) es una confesión religiosa con sede central en Brooklyn , Warwick y Wallkill , en el estado de Nueva York ( Estados Unidos ) fundada por Charles Taze Russell en 1878 .	La organización de los testigos de Jehová ( y la Sociedad Watchtower , principal entidad legal que utilizan ) tiene su sede central en Brooklyn , Nueva York ( Estados Unidos ) desde donde su Cuerpo Gobernante supervisa la obra mundial .
En España , por ejemplo , 70 años después de la muerte del autor sus obras pasan al dominio público .	Según el Convenio de Berna las obras protegidas por el derecho de autor pasan al dominio público a los 50 años de la muerte del autor .
Cualquier paquete de datos enviado por cualquier máquina es recibido por todas las de la red .	En una red multipunto solo existe una línea de comunicación cuyo uso está compartido por todas las terminales en la red .
Las " ciencias de la Tierra " o " geociencias " son las disciplinas de las ciencias naturales que estudian la estructura , morfología , evolución y dinámica del planeta Tierra .	Hoy , las ciencias de la Tierra son una extensión más de las ciencias físicas cuantitativas basadas en el empirismo , la experimentación y la reproducibilidad de las observaciones .
Además de ocupar la mayor parte de la Península Ibérica , España está formada por dos archipiélagos ( el de las Islas Canarias en el océano Atlántico y el de las Islas Baleares en el mar Mediterráneo ) y dos ciudades autónomas ( Ceuta y Melilla ) en el norte de África , aparte de varias islas menores en esta zona y otras cercanas a la península , como el Peñón de Vélez de la Gomera , el Peñón de Alhucemas , las Islas Chafarinas y la Isla del Perejil .	Conforme a la normativa de la Unión Europea , el territorio de este país se divide en tres regiones biogeográficas : mediterránea , atlántica y el archipiélago de las Canarias , en el Océano Atlántico pertenece a la macaronésica .
En mecánica cuántica , el " efecto túnel " es un fenómeno nanoscópico por el que una partícula viola los principios de la mecánica clásica penetrando una barrera de potencial o impedancia mayor que la energía cinética de la propia partícula .	En aplicación a una partícula que se rige bajo los preceptos de la mecánica clásica , esto es considerado " tunelado cuántico " .
La " Tierra " ( de " Terra " , nombre latino de " Gea " , deidad griega de la feminidad y la fecundidad ) es un planeta del Sistema Solar que gira alrededor de su estrella en la tercera órbita más interna .	La desgasificación de la corteza y la actividad volcánica produjeron la atmósfera primordial de la Tierra .
A diferencia de un simulador , que sólo trata de reproducir el comportamiento del programa , un emulador trata de modelar de forma precisa el dispositivo de manera que este funcione como si estuviese siendo usado en el aparato original .	Tanto el sistema de explotación como el programa deben ser interpretados por el emulador , como si estuviese ejecutándose en el equipo original .
Se han obtenido isótopos con números másicos desde 242 a 259 ; el fermio 257 , que es el que tiene una vida más larga , tiene una vida media de 80 días .	El isótopo con vida más larga es 257 Fm , el cual tiene una vida media de unos 100 días .
Los átomos que son isótopos entre sí son los que tienen igual número atómico ( número de protones en el núcleo ) , pero diferente número másico ( suma del número de neutrones y el de protones en el núcleo ) .	Varios isótopos radiactivos inestables y artificiales tienen usos en técnicas de radioterapia en medicina .
" Gran Canaria " es una isla situada en el océano Atlántico , perteneciente a la Comunidad Autónoma de Canarias en España .	La población de la isla en 2011 era de 850.391 habitantes , también es capital de la provincia oriental ( Las Palmas ) y de la Comunidad Autónoma de Canarias , conjuntamente con Santa Cruz de Tenerife .
Existen dos tipos de horarios diferentes : el horario de verano y el horario de invierno ( u horario estándar ) .	Gracias a ello , la tecnología " flash " , siempre mediante impulsos eléctricos , permite velocidades de funcionamiento muy superiores frente a la tecnología EEPROM primigenia , que sólo permitía actuar sobre una única celda de memoria en cada operación de programación .
Venus es normalmente conocido como la estrella de la mañana ( " Lucero del Alba " ) o la estrella de la tarde ( " Lucero Vespertino " ) y , cuando es visible en el cielo nocturno , es el segundo objeto más brillante del firmamento , tras la Luna .	Venus es el astro más característico en los cielos de la mañana y de la tarde de la Tierra ( después del Sol y la Luna ) , y es conocido por el hombre desde la prehistoria .
La " península ibérica " se encuentra situada en el sudoeste de Europa ; está rodeada por el mar Mediterráneo , el océano Atlántico y unida al resto del continente europeo por el noreste .	Por el sur , la península está separada de África ( Marruecos y Argelia ) por el mar Mediterráneo ( que en esta zona se denomina Mar de Alborán ) y el océano Atlántico , siendo el estrecho de Gibraltar el límite entre ambos .
El " himno de la Unión Europea " , oficialmente " Himno Europeo " , es uno de los cuatro símbolos oficiales de la Unión Europea .	Este himno , según la Unión Europea , no sustituye a los himnos nacionales de los países de la UE , sino que " celebra los valores que todos ellos comparten " .
Varsovia es conocida internacionalmente por haber dado su nombre al Pacto de Varsovia .	El bádminton es desde 1992 un deporte olímpico en cinco modalidades : individuales masculino y femenino , dobles masculino y femenino , y dobles mixto , dónde la pareja está compuesta por un hombre y una mujer .
Llamado así por el dios de la guerra de la mitología romana Marte , recibe a veces el apodo de " Planeta rojo " debido a la apariencia rojiza que le confiere el óxido de hierro que domina su superficie .	El 10 de noviembre de 2084 ocurrirá el próximo tránsito de la Tierra por el disco solar visto desde Marte .
La mejora de los transportes y las comunicaciones ha permitido la explotación a gran escala de bienes naturales , sobre todo la madera y el mineral de hierro .	La escasamente poblada Norrland comprende más de la mitad de la superficie del país .
Un compilador es un programa que permite traducir el código fuente de un programa en lenguaje de alto nivel , a otro lenguaje de nivel inferior ( típicamente lenguaje de máquina ) .	Es el proceso por el cual se traducen las instrucciones escritas en un determinado lenguaje de programación a lenguaje máquina .
La " masa " , en física , es una medida de la cantidad de materia que posee un cuerpo .	En física relativista , la masa es función de la velocidad que el cuerpo posee respecto al observador .
La " nutrición autótrofa " es la capacidad de ciertos organismos de sintetizar todas las sustancias esenciales para su metabolismo a partir de sustancias inorgánicas , de manera que para su nutrición no necesitan de otros seres vivos .	Se denominan autótrofos porque generan sus propios alimentos , a través de sustancias inorganicas para su metabolismo .
" Bodhisattva " es un término propio del budismo que alude a alguien embarcado en el camino del Buda de manera significativa .	En el budismo primigenio , se usa para referirse a alguien que está en el camino de la budeidad .
La " programación orientada a objetos " o " POO " ( " OOP " según sus siglas en inglés ) es un paradigma de programación que usa los objetos en sus interacciones , para diseñar aplicaciones y programas informáticos .	La programación orientada a objetos es un paradigma surgido en los años 70 , que utiliza objetos como elementos fundamentales en la construcción de la solución .
El " líquido " es un estado de agregación de la materia en forma de fluido altamente incompresible lo que significa que su volumen es , muy aproximadamente , constante en un rango grande de presión .	El estado líquido es un estado de agregación de la materia intermedio entre el estado sólido y el estado gaseoso .
La Real Academia Española junto con otras veintiuna Academias correspondientes en sendos países donde se habla español , conforman la Asociación de Academias de la Lengua Española .	Estas veintiuna academias constituyen con la Real Academia Española la Asociación de Academias de la Lengua Española ( ASALE ) , fundada en 1951 en el marco del I Congreso de Academias celebrado en México .
En la filosofía shramánica , " nirvana " es el estado de liberación tanto del sufrimiento ( dukkha ) como del ciclo de renacimientos .	El nirvana es el estado transcendente libre de sufrimiento y de la existencia fenoménica individual ; es la experiencia religiosa más identificada con el budismo .
" Los instrumentos de viento " o " aerófonos " son una familia de instrumentos musicales que producen el sonido por la vibración de la masa de aire en su interior , sin necesidad de cuerdas o membranas .	Los instrumentos de viento son aquellos que contienen un volumen gaseoso capaz de producir sonido al ser convenientemente excitado .
El " líquido " es un estado de agregación de la materia en forma de fluido altamente incompresible lo que significa que su volumen es , muy aproximadamente , constante en un rango grande de presión .	La viscosidad es una medida de la resistencia al desplazamiento de un fluido cuando existe una diferencia de presión .
La " provincia de Almería " es una provincia española de la comunidad autónoma de Andalucía , situada en el sureste de la Península Ibérica .	La " televisión " es un sistema para la transmisión y recepción de imágenes en movimiento y sonido a distancia que emplea un mecanismo de difusión .
El " bosón de Higgs " o " partícula de Higgs " es una partícula elemental propuesta en el Modelo estándar de física de partículas .	La existencia del bosón de Higgs y del campo de Higgs asociado serían el más simple de varios métodos del Modelo estándar de física de partículas que intentan explicar la razón de la existencia de masa en las partículas elementales .
La " provincia de Burgos " es una provincia española situada en el norte de la península ibérica y su capital es la ciudad de Burgos .	La provincia de Burgos se localiza en la parte norte de la península Ibérica , en la región histórica de Castilla la Vieja y desde 1983 integrada en la comunidad autónoma de Castilla y León ( España ) .
Fue erigida como Prelatura personal el 28 de noviembre de 1982 mediante la Constitución Apostólica " Ut sit " otorgada por el papa Juan Pablo II .	La Constitución Apostólica " Ut Sit " erigió al Opus Dei como " prelatura personal de la Iglesia Católica " el 28 de noviembre de 1982 .
Los átomos que son isótopos entre sí son los que tienen igual número atómico ( número de protones en el núcleo ) , pero diferente número másico ( suma del número de neutrones y el de protones en el núcleo ) .	Actualmente cada isótopo se representa con el símbolo del elemento al que pertenece , colocando como subíndice a la izquierda su número atómico ( número de protones en el núcleo ) , y como superíndice a la izquierda su número másico ( suma del número de protones y del número de neutrones en el núcleo ) .
La " Historia de América " es la historia colectiva de los pueblos del continente americano , incluidas las Antillas y demás islas próximas .	En la Prehistoria americana , la Cultura Clovis ( de hace 13.500 años aproximadamente ) , es la que más restos arqueológicos deja y la que permite darse una idea de la intensa actividad de los pueblos de cazadores y recolectores que poblaron en el continente .
La " ergonomía " es la disciplina tecnológica que se encarga del diseño de lugares de trabajo , herramientas y tareas que coinciden con las características fisiológicas , anatómicas , psicológicas y las capacidades del trabajador .	La ergonomía física se preocupa de las características anatómicas , antropométricas , fisiológicas y biomecánicas del usuario , en tanto que se relacionan con la actividad física .
La " catálisis " es el proceso por el cual se aumenta la velocidad de una reacción química , debido a la participación de una sustancia llamada " catalizador " y las que desactivan la catálisis son denominados " inhibidores " .	El catalizador puede aumentar la velocidad de reacción o de la selectividad , o permitir que la reacción ocurra a menores temperaturas .
El " tenis " es un deporte que se practica en un terreno llano , rectangular , dividido por una red intermedia , al que se le llama cancha .	El " Reino Unido de Gran Bretaña e Irlanda del Norte " , de manera abreviada " Reino Unido " o " RU " ( en inglés : " United Kingdom of Great Britain and Northern Ireland " ; de manera abreviada : " United Kingdom " , " UK " o " Britain " ) , es un Estado soberano miembro de la Unión Europea ubicado al noroeste de la Europa Continental .
El " Ratoncito Pérez " es un personaje de leyenda muy popular entre los niños españoles e hispanoamericanos .	El Ratoncito Pérez es de los pocos personajes de ficción que tiene residencia real conocida .
El " pársec " o " parsec " ( símbolo " pc " ) es una unidad de longitud utilizada en astronomía .	Por otro lado , en el Episodio 2 , de la misma saga , la senadora Padme utiliza el pársec como una unidad de distancia .
" Iron Maiden " es una banda británica de " heavy metal " fundada en 1975 por el bajista Steve Harris .	Iron Maiden empezó a sufrir de una menor convocatoria de público en sus conciertos , y el desempeño de Blaze en vivo dejaba mucho que desear .
Este calendario tenía un año de 365 días , dividido en tres estaciones , meses de 30 días y " decanos " de diez días .	La " Agencia Adventista de Desarrollo y Recursos Asistenciales " ( ADRA ) ( en inglés " The Adventist Development and Relief Agency " ) es la rama humanitaria mundial de la Iglesia Adventista del Séptimo Día , establecida con el propósito
Una " familia de lenguas " es un grupo de lenguas con un origen histórico común y emparentadas filogenéticamente , es decir , parecen derivar de una lengua más antigua o protolengua ( " lengua madre " ) .	Frecuentemente dentro de una familia es posible reconstruir fidedignamente el origen común o " protolengua madre " de dicha familia .
Históricamente el principio de exclusión de Pauli fue formulado para explicar la estructura atómica , y consistía en imponer una restricción sobre la distribución de los electrones entre los diferentes estados .	El principio de exclusión de Pauli rige , así pues , muchas de las características distintivas de la materia .
La " sífilis " , también conocida como " búas " , " bubas " o " lúes " , es una infección de transmisión sexual crónica producida por la bacteria espiroqueta " Treponema pallidum " , subespecie " pallidum " ( pronunciado " pál lidum " ) .	La sífilis es una forma de la infección tropical de la piel , los huesos y las articulaciones , llamada guiñada ( también " frambesia trópica " , " polypapilloma trópicum " , " thymosis " , " yaws " o " pian " ) causada por la bacteria espiroqueta " Treponema pertenue " .
La superficie de Colombia es de 2.129.748 km² , de los cuales 1.141.748 km² corresponden a su territorio continental y los restantes 988.000 km² a su extensión marítima ,	El área total de Colombia es de 2.129 748 km² conformados por el territorio continental y las aguas marítimas .
El " vatio " o " watt " es la unidad de potencia del Sistema Internacional de Unidades .	Níger es el 22 ° país más grande del mundo , con un área de 1'267.000 km² , que para efectos comparativos es similar a la de Perú o a dos veces y media la de España .
Sin embargo , en el caso de los enteros es necesario calcular también el signo del resultado .	La multiplicación de números enteros , al igual que la suma , requiere determinar por separado el signo y valor absoluto del resultado .
Agadez es con mucho el mayor departamento de Níger , con una superficie de 634.209 km² , lo cual equivale a dos veces el tamaño de Polonia .	Se conoce como " semana " al ciclo compuesto por siete jornadas seguidas ; es decir al período de 7 días naturales con carácter de consecutivos , que de acuerdo a la norma ISO 8601 adoptada por la mayoría de los países del mundo , comienza el lunes y finaliza el domingo ,
Fue fundada el 2 de octubre de 1928 por Josemaría Escrivá de Balaguer , sacerdote español canonizado en 2002 por Juan Pablo II .	El 2 de octubre de 1928 , Josemaría Escrivá de Balaguer funda el " Opus Dei " como « camino de santificación dirigido a toda clase de personas en el trabajo profesional y en el cumplimiento de los deberes ordinarios del cristiano » .
Perl toma características del lenguaje C , del lenguaje interpretado bourne shell ( sh ) , AWK , sed , Lisp y , en un grado inferior , de muchos otros lenguajes de programación .	Estructuralmente , Perl está basado en un estilo de bloques como los del C o AWK , y fue ampliamente adoptado por su destreza en el procesado de texto y no tener ninguna de las limitaciones de los otros lenguajes de script .
En occidente el sistema más comúnmente utilizado los horóscopos , que afirman predecir aspectos de la personalidad de las personas , y poder de predecir el futuro basándose en la posición del sol , la luna y otros elementos en el momento del nacimiento .	Existía una correlación significativa en la posición de Marte en el momento del nacimiento con la calidad de los deportistas del estudio .
El " vino " ( del latín " vinum " ) es una bebida obtenida de la uva ( especie " Vitis vinifera " ) mediante la fermentación alcohólica de su mosto o zumo .	El metal más abundante en las frutas de la " vitis vinífera " es el potasio .
En el islam , donde se lo conoce como Isa , es considerado uno de los profetas más importantes .	Según el Corán , fue uno de los profetas más queridos por Dios y , a diferencia de lo que ocurre en el cristianismo , para los musulmanes no tiene carácter divino .
Los " números hiperreales " son una extensión del conjunto de los números reales que permiten entre otros formalizar algunas operaciones con infinitésimos , y probar algunos resultados clásicos del análisis real de manera más sencilla .	Los números reales convencionales son una realización posible de la llamada teoría de primer orden de los números reales .
" Andalucía " es una comunidad autónoma de España , con estatus de nacionalidad histórica , de acuerdo con el Estatuto de Autonomía que la rige .	Andalucía alcanzó la titularidad de las competencias sanitarias con la promulgación de su Estatuto de Autonomía , que fue desarrollado a través de un proceso de transferencias de competencias sanitarias desde el Estado a la Comunidad Autónoma .
La " ingeniería " es el conjunto de conocimientos y técnicas científicas aplicadas a la creación , perfeccionamiento e implementación de estructuras ( tanto físicas como teóricas ) para la resolución de problemas que afectan la actividad cotidiana de la sociedad .	Otra característica que define a la ingeniería es la aplicación de los conocimientos científicos a la invención o perfeccionamiento de nuevas técnicas .
Un " espacio natural , " " paisaje natural " o un " ambiente natural " , es una parte del territorio de la tierra que no se encuentra modificado por la acción del hombre .	El paisaje natural es aquello que no está modificado por el hombre , a pesar de algunos pequeños enclaves .
Por tanto el único objetivo de la criptografía era conseguir la " confidencialidad " de los mensajes .	El objetivo de la criptografía es diseñar , implementar , implantar , y hacer uso de sistemas criptográficos para dotar de alguna forma de seguridad .
El " ajedrez " es un juego entre dos personas , cada una de las cuales dispone de 16 piezas móviles que se colocan sobre un tablero dividido en 64 escaques .	El ajedrez no es un juego de azar , sino un juego racional , ya que cada jugador decidirá el movimiento de sus piezas en cada turno .
" Ponferrada " es un municipio y ciudad de España , capital de la comarca de El Bierzo , en la provincia de León , comunidad autónoma de Castilla y León .	La ciudad de Ponferrada es la sexta ciudad más poblada de Castilla y León , superando en número de habitantes a cuatro capitales de provincia y al resto de municipios de la Comunidad Autónoma .
Está formada por los 919 municipios que integran las provincias de Albacete , Ciudad Real , Cuenca , Guadalajara y Toledo .	En Castilla-La Mancha existían en 2011 , 137 mancomunidades que se reparten de la siguiente manera : Albacete cuenta con 16 mancomunidades , Ciudad Real cuenta con 19 , Cuenca con 46 , Guadalajara con 32 y Toledo con 24 .
A pesar de ello , cuando Venus es más brillante , puede ser visto durante el día , siendo uno de los tres únicos cuerpos celestes que pueden ser vistos de día a simple vista , además de la Luna y el Sol .	Venus es normalmente conocido como la estrella de la mañana ( " Lucero del Alba " ) o la estrella de la tarde ( " Lucero Vespertino " ) y , cuando es visible en el cielo nocturno , es el segundo objeto más brillante del firmamento , tras la Luna .
El " calendario gregoriano " es un calendario originario de Europa , actualmente utilizado de manera oficial en casi todo el mundo .	A pesar de que en sus países el calendario gregoriano es el oficial , las iglesias ortodoxas ( excepto la de Finlandia ) siguen utilizando el calendario juliano ( o modificaciones de él diferentes al calendario gregoriano ) .
El " alfabeto " o " abecedario " de una lengua o idioma es el conjunto ordenado de sus letras .	El alfabeto de los pueblos germánicos , llamado " futhark " ( las runas y los oghams ) por el nombre de sus seis primeras letras , se redujo de 26 signos a 16 .
En la Asamblea General de la Unión Astronómica Internacional ( UAI ) celebrada en Praga el 24 de agosto de 2006 se creó una nueva categoría llamada plutoide , en la que se incluye a Plutón .	La " constante de gravitación universal " es una constante física obtenida de forma empírica , que determina la intensidad de la fuerza de atracción gravitatoria entre los cuerpos .
" Simone de Beauvoir " ( París , 9 de enero de 1908-París , 14 de abril de 1986 ) fue una escritora , profesora y filósofa francesa .	Simone de Beauvoir fue profesora de filosofía hasta 1943 en escuelas de diferentes lugares de Francia , como Ruan y Marsella .
Las fuentes de renta más importantes de Nuevo Brunswick son la manufactura , el turismo , la silvicultura , la minería y la pesca .	Después de la formación de la Confederación , Nuevo Brunswick continuó creciendo económicamente , apoyándose en la pesca , la minería y la silvicultura .
La " heráldica " es la ciencia del blasón ( « blasón » , según la RAE se define como el « arte de explicar y describir los escudos de armas de cada linaje , ciudad o persona » ) .	La heráldica es lo relativo al lenguaje del blasón , a la ciencia de los heraldos y al diseño de las armerías .
El " gobierno " es , normalmente , la autoridad que dirige , controla y administra las instituciones del Estado el cual consiste en la conducción política general o ejercicio del poder del Estado .	En términos amplios , el gobierno es aquella estructura que ejerce las diversas actividades estatales , denominadas comúnmente poderes del Estado ( funciones del Estado ) .
" El Señor de los Anillos " ( título original en inglés : " The Lord of the Rings " ) es una novela de fantasía épica escrita por el filólogo y escritor británico J. R. R. Tolkien .	Si bien es cierto que " El Señor de los Anillos " fue concebida como una continuación de " El hobbit " , argumentalmente lo es de " El Silmarillion " , obra que relata los acontecimientos de los Días Antiguos y en la que se construye toda la trama del " legendarium " que creó J. R. R. Tolkien .
La " Segunda Guerra Mundial " fue un conflicto militar global que se desarrolló entre 1939 y 1945 .	La Segunda Guerra Mundial alteró las relaciones políticas y la estructura social del mundo .
Grecia además es miembro de la Unión Europea desde 1981 y de la Unión Monetaria y Económica desde 2001 , de la OTAN desde 1952 y de la Agencia Espacial Europea desde 2005 .	Grecia es un país miembro de la Unión Europea ( UE ) situado en el extremo sur de la Península Balcánica en el litoral del Mar Mediterráneo .
Se denomina " transporte " o " transportación " ( del latín " trans " , " al otro lado " , y " portare " , " llevar " ) al traslado de un lugar a otro de algún elemento , en general personas o bienes .	El transporte de carga es la disciplina que estudia la mejor forma de llevar de un lugar a otro bienes .
La " semántica lingüística " es un subcampo de la semántica general y de la lingüística que estudia la codificación del significado dentro de las expresiones lingüísticas .	La transmisión de información requiere algún tipo de codificación del contenido semántico en forma de expresiones lingüísticas .
La " parapsicología " es una pseudociencia que estudia los fenómenos paranormales o fenómenos psi ( como la percepción extrasensorial , telequinesia , telepatía , precognición , clarividencia , las experiencias extracorpóreas , el espiritismo y los poltergeist ) .	El psi es una entidad creada para intentar comprender la supuesta mecánica de los fenómenos parapsicológicos , entre los que se incluirían la percepción extrasensorial , la telepatía , la clarividencia , la precognición , la psicoquinesis , los poltergeist , las experiencias cercanas a la muerte , la mediumnidad , las experiencias extracorpóreas o la sanación milagrosa .
" Gabrielle Bonheur " Coco " Chanel " ( Saumur , 19 de agosto de 1883 - París , 10 de enero de 1971 ) fue una diseñadora de moda francesa .	Hija de un vendedor ambulante y una ama de casa , ambos de escasos recursos , Gabrielle Chanel nació en un hospicio de Saumur , el 19 de agosto de 1883 .
" Paul Adrien Maurice Dirac " , OM , FRS ( 8 de agosto de 1902 - 20 de octubre de 1984 ) fue un físico teórico británico que contribuyó de forma fundamental al desarrollo de la mecánica cuántica y la electrodinámica cuántica .	Fue uno de los fundadores de la mecánica cuántica y la electrodinámica cuántica , siendo considerado por algunos físicos como el físico más relevante del siglo XX .
La " evolución biológica " es el conjunto de transformaciones o cambios a través del tiempo que ha originado la diversidad de formas de vida que existen sobre la Tierra a partir de un antepasado común .	No obstante , el concepto de que la vida en la Tierra evolucionó a partir de un ancestro común ya había sido formulado por varios filósofos griegos .
El " potencial eléctrico " o " potencial electrostático " en un punto , es el trabajo que debe realizar un campo electrostático para mover una carga positiva " q " desde dicho punto hasta el punto de referencia , dividido por unidad de carga de prueba .	El " surf " es un deporte que consiste en deslizarse en una ola de pie sobre una tabla .
A cada una de las partículas de la naturaleza le corresponde una " antipartícula " que posee la misma masa , el mismo espín , pero distinta carga eléctrica .	De esta forma Feynman llegó a entender de forma gráfica el hecho de que la partícula y su antipartícula tuvieran la misma masa " m " y spin " J " pero cargas opuestas .
En sentido estricto , la democracia es una forma de organización del Estado en la cual las decisiones colectivas son adoptadas por el pueblo mediante mecanismos de participación directa o indirecta que confieren legitimidad a sus representantes .	" Democracia " es una forma de organización social que atribuye la titularidad del poder al conjunto de la sociedad .
Fue propuesto por Hugo Ball , escritor de los primeros textos dadaístas ; posteriormente , se unió el rumano Tristan Tzara que llegaría a ser el emblema del Dadaísmo .	Posteriormente fue adoptado por Tristan Tzara , quien se convertiría en la figura más representativa del Dadaísmo .
La " robótica " es la rama de la tecnología que se dedica al diseño , construcción , operación , disposición estructural , manufactura y aplicación de los robots .	El término robótica es acuñado por Isaac Asimov , definiendo a la ciencia que estudia a los robots .
La Ciudad del Vaticano alberga la Santa Sede , máxima institución de la Iglesia católica .	La máxima autoridad del Vaticano y jefe de Estado del mismo es el sumo pontífice , por lo que puede considerarse la única teocracia de Europa .
El " Principado de Andorra " ( en catalán : " Principat d'Andorra " ) es un pequeño principado soberano del suroeste de Europa con una extensión de 468 km 2 , situado en los Pirineos entre España y Francia , con una altitud media de 1.996 metros sobre el nivel del mar .	La montaña más alta es el pico de Comapedrosa que , con una altitud de 2.942 msnm , está situado en la cordillera de los Pirineos , enclavado entre la frontera de España y Francia .
Se denomina " metal " a los elementos químicos caracterizados por ser buenos conductores del calor y la electricidad .	Mediante la teoría del « gas electrónico » podemos explicar por que los metales son tan buenos conductores del calor y la electricidad , pero es necesario comprender la naturaleza del enlace entre sus átomos .
Se denomina " veterinaria " ( del latín " veterinae " , bestia o animal de carga ) a la ciencia médica de prevenir , diagnosticar y curar las enfermedades de los animales domésticos , animales silvestres y animales de producción .	La ciencia veterinaria ayuda a salvaguardar la salud humana mediante la vigilancia de la salud de los animales domésticos y de la fauna silvestre .
En Teoría de la Información se denomina " distancia de Hamming " a la efectividad de los códigos de bloque y depende de la diferencia entre una palabra de código válida y otra .	La distancia de Hamming se denomina así gracias a su inventor Richard Hamming , profesor de la Universidad de Nebraska , que fue el que introdujo el término para establecer una métrica capaz de establecer un " código para la detección y auto-corrección de códigos " .
" La llamada de Cthulhu " es un juego de rol de horror ambientado en los años veinte y en particular en los « mitos de Cthulhu » , universo de ficción iniciado por el escritor estadounidense Howard Phillips Lovecraft .	Otro juego de rol ambientado en los mitos de Cthulhu pero adaptado a un entorno de ciencia ficción es " CthulhuTech " .
El tratamiento quirúrgico del cáncer de mama también se propone el tratamiento de los ganglios linfáticos	axilares .
El " hiperrealismo " es una tendencia radical de la pintura realista surgida en Estados Unidos a finales de los años 60 del siglo XX que propone reproducir la realidad con más fidelidad y objetividad que la fotografía .	El término " hiperrealismo " es también aplicable a la escultura y la historieta ( Luis García , Alex Ross , etc ) .
Los " Reyes Magos de Oriente " ( o simplemente " Reyes Magos " ) es el nombre por el que la tradición denomina a los visitantes que , tras el nacimiento de Jesús de Nazaret , acudieron desde países extranjeros para rendirle homenaje y entregarle regalos de gran riqueza simbólica : oro , incienso y mirra .	C , « los Magos son de Oriente pero que en esa inquietud por buscar a Dios están representados los hombres buscadores de Dios de todos los lugares y de todos los tiempos » .
El " Sol " ( del latín " sol " , " solis " , a su vez de la raíz proto-indoeuropea " sauel- " ) Por sí solo , representa alrededor del 98,6 por ciento de la masa del Sistema Solar .	El Sol , junto con todos los cuerpos celestes que orbitan a su alrededor , incluida la Tierra , forman el Sistema Solar .
La crisis económica Argentina de fines del 2001 paraliza este desarrollo que recién se recupera con la expansión que se da en el área de la construcción casi tres años después .	La " prostitución " se define como el acto de participar en actividades sexuales o hacer el sexo a cambio de dinero o bienes .
El " Principado de Andorra " ( nombre local , " Principat d'Andorra " ) es un estado de la Europa meridional , situado en la cordillera de los Pirineos orientales .	Es un estado sin litoral , en el que se encuentran importantes cruces de caminos de los Pirineos .
Las bacterias son procariotas y , por lo tanto , a diferencia de las células eucariotas ( de animales , plantas , hongos , etc. ) , no tienen el núcleo definido ni presentan , en general , orgánulos membranosos internos .	Puesto que las bacterias son procariotas no tienen orgánulos citoplasmáticos delimitados por membranas y por ello presentan pocas estructuras intracelulares .
La banda sonora corrió a cargo de Wojciech Kilar , excepto el tema final " Canción de amor para un vampiro " , que fue compuesto por Annie Lennox .	El tema principal de la película " Love Song for a Vampire " ( " Canción de amor para un vampiro " ) fue escrita por Annie Lennox , que juntándola con el trabajo de Kilar , saldría al mercado un disco con la banda sonora y los temas interpretados por Lennox .
La " peseta " fue la unidad monetaria en España desde su aprobación el 19 de octubre de 1868 hasta el 1 de enero de 1999 , cuando se introdujo el euro .	El 31 de diciembre de 1998 , la peseta dejó de cotizar y fue sustituida por el euro .
La peseta siguió circulando hasta el 31 de diciembre de 2001 con la consideración legal de « fracción no decimal de euro » y después , provisionalmente , hasta el 28 de febrero de 2002 .	Las pesetas siguieron en circulación hasta el 28 de febrero de 2002 , con la entrada del euro , tras 133 años de vigencia .
El " Proterozoico " , una división de la escala temporal geológica , es un eón geológico perteneciente al Precámbrico que abarca desde hace 2.500 millones de años hasta hace 542 millones de años , durando 1958 millones de años,0 ± 1,0 millones de años .	Es la rama de la lingüística que estudia la producción y percepción de los sonidos de una lengua con respecto a sus manifestaciones " físicas " .
En condiciones normales de presión y temperatura , dos átomos del elemento se enlazan para formar el dioxígeno , un gas diatómico incoloro , inodoro e insípido con fórmula O 2 .	En condiciones normales de presión y temperatura , el oxígeno es un gas incoloro e inodoro con fórmula molecular O 2 , en el que dos átomos de oxígeno se enlazan con una configuración electrónica en estado triplete .
Habermas es el miembro más eminente de la segunda generación de la Escuela de Frankfurt y uno de los exponentes de la Teoría crítica desarrollada en el Instituto de Investigación Social .	Se apoya en la idea de una completa transformación de la crítica del conocimiento en crítica de la sociedad .
El " ciclismo " es un deporte que implica el uso de la bicicleta para recorrer circuitos al aire libre , en pista cubierta , o que engloba diferentes especialidades como las que se menciona abajo .	El " sarampión " es una enfermedad infecciosa exantemática como la rubéola y la varicela , bastante frecuente , especialmente en niños causada por un virus , específicamente un paramixovirus del género " Morbillivirus " .
El " diseño visual " o " diseño en comunicación visual " es una disciplina profesional que estudia los sistemas de información , con el objeto de convertir los datos en formas visuales , teniendo en cuenta los procesos perceptivos .	La " Antártida " o " continente antártico " , es el continente sobre el cual se encuentra el Polo Sur .
Durante buena parte del siglo XX ( principalmente la primera mitad ) tuvo lugar un período de gran crecimiento económico en el marco de una política dominada por un solo partido político .	La mayor parte de la red de ferrocarriles sirve en la actualidad para el transporte de mercancías .
El " lenguaje de consulta estructurado " o " SQL " ( por sus siglas en inglés " structured query language " ) es un lenguaje declarativo de acceso a bases de datos relacionales que permite especificar diversos tipos de operaciones en ellas .	El SQL es un lenguaje de acceso a bases de datos que explota la flexibilidad y potencia de los sistemas relacionales y permite así gran variedad de operaciones .
En la década de 1980 , la escolarización universal y la industrialización permitieron al país desarrollar una exitosa industria manufacturera .	La gran mayoría de sus habitantes nacidos después de la Segunda Guerra Mundial entienden y hablan el inglés gracias a los vínculos comerciales , la popularidad de los viajes al extranjero y una fuerte influencia anglo-estadounidense .
La " historia del cristianismo " se refiere a la religión cristiana , sus seguidores y de la Iglesia , con sus diferentes denominaciones , desde el siglo I hasta la actualidad .	La política romana era tolerante a la religión y las costumbres de los pueblos conquistados .
" Argentina " , oficialmente " República Argentina " , es un país de América , organizado como república representativa y federal , situado en el extremo sureste y sur de América del Sur .	La Argentina es el país más visitado de América del Sur y el cuarto más visitado del continente americano .
" Joaquín Ramón Martínez Sabina " ( Úbeda , Jaén , 12 de febrero de 1949 ) , conocido artísticamente como " Joaquín Sabina " , es un cantautor y poeta español de éxito en países de habla hispana .	Joaquín Sabina nace el 12 de febrero de 1949 en la localidad de Úbeda ( Jaén , España ) , segundo hijo de Adela Sabina del Campo , ama de casa y de Jerónimo Martínez Gallego , inspector de policía . que se dedicaban sobre todo a versionar a cantantes de rock como Elvis Presley , Chuck Berry o Little Richard .
El " reggae " es un género musical que se desarrolló por primera vez en Jamaica hacia mediados de los años 1960 .	El Rap es un estilo de cantar o hablar sobre un disco instrumental que fue utilizado por primera vez en Jamaica en 1960 , donde se le conocía como Toasting , por deejays como U-Roy y Dennis Alcapone .
El fin de este arte es suscitar una experiencia estética en el oyente , y expresar sentimientos , circunstancias , pensamientos o ideas .	La mayoría de los estudiosos coincide en el aspecto de la estructura , es decir , en el hecho de que la música implica una organización ; pero algunos teóricos modernos difieren en que el resultado deba ser placentero o agradable .
En el siglo VII , los musulmanes habían comenzado una rápida expansión en la que ocuparon Oriente Medio y el norte de África , llegando a la Península Ibérica a principios del siglo siguiente , en el marco del último proceso expansionista del Califato Omeya de Damasco .	Hacia el 718 la Península Ibérica , salvo las zonas montañosas del norte habitadas por Vascones , Cántabros y Astures , estaba en manos del Califato Omeya .
El " Derecho procesal civil " es una rama del Derecho procesal que regula la actuación ante los Tribunales para obtener la tutela de los derechos en asuntos de naturaleza civil o mercantil .	El derecho procesal civil es el conjunto de normas jurídicas adjetivas de orden público que regulan los trámites necesarios para la aplicación de las instituciones sustantivas previstas en la legislación civil de un Estado .
El " modelo estándar " de la física de partículas es una teoría que describe las relaciones entre las interacciones fundamentales conocidas y las partículas elementales que componen toda la materia .	Dentro de esto , el modelo estándar agrupa dos teorías importantes - el modelo electrodébil y la cromodinámica cuántica- lo que proporciona una teoría internamente consistente que describe las interacciones entre todas las partículas observadas experimentalmente .
Obtuvo el premio Nobel de Medicina en 1906 por descubrir los mecanismos que gobiernan la morfología y los procesos conectivos de las células nerviosas , una nueva y revolucionaria teoría que empezó a ser llamada la « " doctrina de la neurona " » , basada en que el tejido cerebral está compuesto por células individuales .	Fue en 1888 , definido por el propio Ramón y Cajal como su " año cumbre " , cuando descubrió los mecanismos que gobiernan la morfología y los procesos conectivos de las células nerviosas de la materia gris del sistema nervioso cerebroespinal .
La masa del neutrino tiene importantes consecuencias en el modelo estándar de física de partículas , ya que implicaría la posibilidad de transformaciones entre los tres tipos de neutrinos existentes en un fenómeno conocido como oscilación de neutrinos .	Los neutrinos pueden pasar de una familia a otra ( es decir , cambiar de sabor ) en un proceso conocido como oscilación de neutrinos .
Una " máquina de Turing " es un dispositivo que manipula símbolos sobre una tira de cinta de acuerdo a una tabla de reglas .	Una máquina de Turing es un modelo computacional que realiza una lectura / escritura de manera automática sobre una entrada llamada cinta , generando una salida en esta misma .
La Ciudad del Vaticano alberga la Santa Sede , máxima institución de la Iglesia católica .	La autora del libro comenta que la gastronomía de este país es « una de las más complejas y ricas del mundo , mucho más que la de cualquier Casa Real » .
La familia , cuyo nombre deriva del género Iris , cuenta con más de 2.000 especies que se distribuyen por casi todo el mundo , siendo una de las familias más importantes en horticultura .	La familia comprende aproximadamente 70 géneros y más de 1600 especies , distribuidas por todo el globo , con una marcada concentración de especies en el Hemisferio Sur y el mayor centro de radiación en África , al sur del Sahara .
Por otra parte la ictiología además se ocupa de la biología y comportamiento de los peces .	La obra " Regne animal distribué d'après son organisation " de Georges Cuvier , publicada entre 1817-1830 fue un paso clave para la clasificación de los peces .
El " Sistema Solar " es un sistema planetario en el que se encuentra la Tierra .	El gas interplanetario es un tenue flujo de gas y partículas cargadas que forman un plasma que es expulsado por el Sol en el viento solar .
El " himno nacional " es , en la mayoría de los casos , una composición musical patriótica aceptada por el gobierno de un país como la música oficial del Estado .	Durante los diecisiete años que pasaron en Hartford y los veinte en Quarry Farm , Twain escribió muchas de sus novelas clásicas , como " Las aventuras de Tom Sawyer " ( 1876 ) , " El príncipe y el mendigo " ( 1881 ) , " Vida en el Misisipi " ( 1883 ) , " Las aventuras de Huckleberry Finn " ( 1885 ) y " Un yanqui en la corte del Rey Arturo " ( 1889 ) .
El cáncer es una enfermedad genética producida por la mutación en unos genes determinados .	Estas mutaciones deben provocar alguna alteración en la secuencia de protooncogenes y genes supresores de tumores , los cuales son los encargados de regular el ciclo celular y la muerte celular programada ( apoptosis ) .
En informática , un " disco duro " o " disco rígido " ( en inglés " Hard Disk Drive " , HDD ) es un dispositivo de almacenamiento de datos no volátil que emplea un sistema de grabación magnética para almacenar datos digitales .	Una " unidad de estado sólido " o " SSD " ( acrónimo en inglés de " solid-state drive " ) es un dispositivo de almacenamiento de datos que puede estar construido con memoria no volátil o con memoria volátil .
La " teoría de la relatividad " está compuesta a grandes rasgos por dos grandes teorías ( la de la relatividad especial y la de la relatividad general ) formuladas por Albert Einstein a principios del siglo XX , que pretendían resolver la incompatibilidad existente entre la mecánica newtoniana y el electromagnetismo .	La teoría de la relatividad especial , también llamada teoría de la relatividad restringida , fue publicada por Albert Einstein en 1905 y describe la física del movimiento en el marco de un espacio-tiempo plano .
Quizá su faceta menos conocida es su proyecto ( en 1935 ) de un motor a reacción ( denominado " Mototurbocompresor de Reacción Continua " ) que el inicio de la Guerra Civil le impidió comenzar .	Durante el tiempo que estuvo en prisión diseñó un motor a reacción , original y revolucionario para su época , al que denominó Mototurbocompresor de Reacción Continua .
Entre otros descubrimientos formuló la ecuación de Dirac que describe el comportamiento de los fermiones y con la cual predijo la existencia de la antimateria .	Dirac fundó la teoría cuántica de campos con su interpretación de la ecuación de Dirac como una ecuación de muchos cuerpos , con la cual predijo la existencia de la antimateria así como los procesos de aniquilación de materia y antimateria .
Generalmente el karma se interpreta como una « ley » cósmica de retribución , o de causa y efecto .	En cambio , según Yogananda , no habría ministros para ejecutar la ley del karma , sino que ésta se ejecutaría a sí misma como ley cósmica , astral o espiritual de forma automática .
La " Real Colegiata Basílica de San Isidoro " o , simplemente , " San Isidoro de León " , es un templo cristiano ubicado en la ciudad de León , en España .	El gallo-veleta de la torre de San Isidoro fue durante siglos el símbolo más preciado de la ciudad de León .
Posteriormente , durante cerca de un siglo el país se vio envuelto en una serie de guerras internas e invasiones extranjeras que tuvieron repercusiones en todos los ámbitos de la vida de los mexicanos .	El español es la lengua dominante en asuntos oficiales y es el idioma materno de la mayoría de los mexicanos .
El código ASCII utiliza 7 bits para representar los carácteres , aunque inicialmente empleaba un bit adicional ( bit de paridad ) que se usaba para detectar errores en la transmisión .	En el momento en el que se introdujo el código ASCII muchos ordenadores trabajaban con grupos de ocho bits ( bytes u octetos ) , como la unidad mínima de información ; donde el octavo bit se usaba habitualmente como bit de paridad con funciones de control de errores en líneas de comunicación u otras funciones específicas del dispositivo .
La neuroanatomía es el estudio de la estructura y la organización del sistema nervioso .	El primer registro escrito conocido de un estudio de la anatomía del cerebro humano es egipcio , el papiro de Edwin Smith .
" El Señor de los Anillos " ( título original en inglés : " The Lord of the Rings " ) es una novela de fantasía épica escrita por el filólogo y escritor británico J. R. R. Tolkien .	J. R. R. Tolkien planeó " El Señor de los Anillos " como una secuela de su anterior novela , " El hobbit " , pero terminó por convertirse en una historia de mucho más alcance y extensión que , escrita por etapas entre 1937 y 1949 , se publicó por primera vez en el Reino Unido entre 1954 y 1955 en tres volúmenes .
No se conserva ningún fragmento suyo y es probable que no dejara ningún escrito a su muerte .	La filosofía de Tales de Mileto , no se conoce de primera mano , pues no ha sobrevivido ningún escrito de Tales ( de hecho , ni siquiera es seguro que haya escrito algo ) .
Aunque el culombio es una unidad derivada del Sistema Internacional , en las baterías eléctricas es muy frecuente utilizar la unidad AH ( Amperio-hora ) , que refleja la cantidad de carga total que puede acumular la batería .	El peso equivale a la fuerza que ejerce un cuerpo sobre un punto de apoyo , originada por la acción del campo gravitatorio local sobre la masa del cuerpo .
La expresión " electrónica de potencia " se utiliza para diferenciar el tipo de aplicación que se le da a dispositivos electrónicos , en este caso para transformar y controlar voltajes y corrientes de niveles significativos .	En este tipo de aplicación se reencuentran la electricidad y la electrónica , pues se utiliza el control que permiten los circuitos electrónicos para controlar la conducción ( encendido y apagado ) de semiconductores de potencia para el manejo de corrientes y voltajes en aplicaciones de potencia .
Está situado en el corazón de la ciudad , en una colina situada entre los ríos Bernesga y Torío , cuya posición elevada entre dos fuentes de agua continuas decidió la creación del campamento de la Legio VI Victrix , origen de la ciudad .	El casco antiguo de León se ubica en el centro de la ciudad y sobre una colina desde la que se domina gran parte del espacio comprendido entre los ríos Bernesga y Torío .
En un átomo , el número de protones en el núcleo determina las propiedades químicas del átomo y qué elemento químico es .	En química , el número de protones en el núcleo de un átomo se conoce como número atómico ( Z ) , y determina el elemento químico al que pertenece el átomo .
" Blade Runner " es una película de ciencia ficción estadounidense , dirigida por Ridley Scott , estrenada en 1982 y basada parcialmente en la novela de Philip K. Dick " ¿ Sueñan los androides con ovejas eléctricas ? " ( 1968 ) .	Michael Green trabaja en el guión de la secuela de " Blade Runner " sobre una historia escrita por Hampton Fancher , guionista de la película original basada en la novela de Philip K. Dick " ¿ Sueñan los androides con ovejas eléctricas ? " .
Generalmente el karma se interpreta como una « ley » cósmica de retribución , o de causa y efecto .	Según los hindúes , el karma es una « ley » de acción y reacción : a cada acción cometida le corresponde una reacción igual y opuesta .
El tratamiento del cáncer de la mama es multidisciplinario , es decir precisa la combinación de diversas modalidades o disciplinas terapéuticas para conseguir un control eficaz de la enfermedad .	Las modalidades terapéuticas contra el cáncer de mama son la cirugía , la radioterapia , la quimioterapia , la hormonoterapia y la terapia biomolecular .
A esta diferencia se le llama distancia de Hamming , y se define como el número de bits que tienen que cambiarse para transformar una palabra de código válida en otra palabra de código válida .	La distancia de Hamming se denomina así gracias a su inventor Richard Hamming , profesor de la Universidad de Nebraska , que fue el que introdujo el término para establecer una métrica capaz de establecer un " código para la detección y auto-corrección de códigos " .
La " quiromancia " o " quiromancía " es el intento de la adivinación a través de la lectura de las líneas de la mano .	Se suele decir que en las manos se puede conocer el destino de una persona y adivinar sucesos pasados , presentes y futuros .
" JPEG " ( del inglés " Joint Photographic Experts Group " , Grupo Conjunto de Expertos en Fotografía ) es el nombre de un comité de expertos que creó un estándar de compresión y codificación de archivos e imágenes fijas .	El formato JPEG utiliza habitualmente un algoritmo de compresión con pérdida para reducir el tamaño de los archivos de imágenes .
El " Dalái Lama " ( de la palabra mongola " dalai " , « océano » , y de la tibetana " lama " , « maestro espiritual » o « gurú » ) es el título que obtiene el dirigente del Gobierno tibetano en el exilio y el líder espiritual del lamaísmo o budismo tibetano antes de la invasión china .	En marzo de 2011 el Dalái Lama anunció que renunciaba a todos los cargos políticos que tenía en su poder del Gobierno tibetano en el exilio , para quedar sólo como líder espiritual y religioso .
La mayoría de las fuentes cita como fecha de fundación de la ciudad el 26 de julio de 1325 , de acuerdo con la información proporcionada por los mexicas y que se encuentra registrada en varios documentos .	La mayor parte de las fuentes históricas señalan que la fundación de México-Tenochtitlan ocurrió en el año 1325 .
La palabra " judaísmo " se refiere a la religión , la tradición y la cultura del pueblo Judío .	Los judíos , una vez conquistada la ciudad de Jericó , se establecieron en la zona agrícola de Canaán , tierra de la cual en la " Biblia " se dice que « manaba la leche y la miel » .
La ciudad está situada en el valle de Guayangareo , formado por un repliegue del Eje Neovolcánico Transversal , en la región norte del estado , en el centro-occidente del país .	La ciudad se encuentra situada en un amplio valle antiguamente llamado Valle de Guayangareo , en el centro-norte del municipio , el cual se encuentra rodeado de lomas y colinas entre las que destacan al este el cerro del Punhuato , al oeste el pico del Quinceo , al sur las lomas de Santa María y el pico de El Águila .
La información es tratada como magnitud física , caracterizando la información de una secuencia de símbolos utilizando la entropía .	De acuerdo a la teoría de la información , el nivel de información de una fuente se puede medir según la entropía de la misma .
El valor de la velocidad de la luz en el vacío fue incluido oficialmente en el Sistema Internacional de Unidades como constante el 21 de octubre de 1983 ,	Si se combina esta observación con el principio de relatividad , se concluye que todos los observadores medirán la velocidad de la luz en el vacío como una misma , sin importar el marco de referencia del observador o la velocidad del objeto que emite la luz .
Muchas bacterias disponen de flagelos o de otros sistemas de desplazamiento y son móviles .	Muchas bacterias tienen una capa S de moléculas de proteína de estructura rígida que cubre la pared celular .
El urbanismo utiliza a la geografía urbana como herramienta fundamental , e intenta comprender los procesos urbanos a fin de planificar las intervenciones para la cualificación del espacio .	La " urbanística , " es el conjunto de técnicas que derivadas del urbanismo sirven para la intervención urbana , en ellas se sistematizan los procesos urbanos a fin de lograr una eficacia de la intervención urbana .
La psicología explora conceptos como la percepción , la atención , la motivación , la emoción , el funcionamiento del cerebro , la inteligencia , la personalidad , las relaciones personales , la consciencia y la inconsciencia .	La " psicología básica " es la parte de la psicología que tiene como función fundamental la recopilación y organización estructurada de conocimientos nuevos acerca de los fundamentos de actuación de los procesos psicológicos básicos , como la percepción , la atención , la memoria , el lenguaje , el aprendizaje , el razonamiento y la resolución de problemas .
Las memorias de computadora proporcionan una de las principales funciones de la computación moderna , la retención o almacenamiento de información .	La " lógica " es una ciencia formal que estudia los principios de la demostración e inferencia válida .
El " genotipo " se refiere a la información genética que posee un organismo en particular , en forma de ADN .	El fenotipo se refiere a la expresión del genotipo más la influencia del medio .
Esta licencia fue creada originalmente por Richard Stallman fundador de la Free Software Foundation ( FSF ) para el proyecto GNU ( GNU project ) .	La licencia GPL fue creada por Richard Stallman en 1989 para proteger los programas liberados como parte del proyecto GNU .
También se denomina así al conjunto de reglas y principios que gobiernan el uso de una lengua concreta determinada ; así , cada lengua tiene su propia gramática .	También se han creado lenguajes como parte de un mundo de ficción ( como el klingon y el quenya ) , y cada uno de ellos tiene su propia gramática .
Con alrededor de 52.000 hectáreas de área agrícola , Roma es la ciudad más verde de Europa .	" Benidorm " es un municipio de la provincia de Alicante , en la Comunidad Valenciana , España .
La ley de la " conservación de la energía " afirma que la cantidad total de energía en cualquier sistema físico aislado ( sin interacción con ningún otro sistema ) permanece invariable con el tiempo , aunque dicha energía puede transformarse en otra forma de energía .	" Arabia Saudita " o " Arabia Saudí " , es una monarquía de Oriente Medio en la península arábiga .
En caso que no se acompañe el término " día " con otro vocablo , debe entenderse como día solar medio , base del tiempo civil , que se divide en 24 horas , de 60 minutos , de 60 segundos , y dura , por tanto , 86.400 segundos	A efectos prácticos se maneja el concepto de día solar medio , que tiene una duración de 24 horas , o lo que es lo mismo , 86.400 segundos .
Un " texto " es una composición de signos codificado en un sistema de escritura ( como un alfabeto ) que forma una unidad de sentido .	Este " texto " o conjunto de signos extraídos de un discurso debe reunir condiciones de textualidad .
Durante sus últimos años trabajó por integrar en una misma teoría la fuerza gravitatoria y la electromagnética .	Einstein dedicó sus últimos años a la búsqueda de una de las más importantes teorías de la física , la llamada Teoría de Campo Unificada .
La superficie de Colombia es de 2.129.748 km² , de los cuales 1.141.748 km² corresponden a su territorio continental y los restantes 988.000 km² a su extensión marítima ,	El territorio continental de Colombia es de 1.141.748 km² y las aguas marítimas de 658.000 km² , de los cuales 339.500 km² corresponden al mar Caribe y 318.500 km² al océano Pacífico .
El " jazz " es un género musical nacido en la segunda mitad del siglo XIX en Estados Unidos , que se expandió de forma global a lo largo de todo el siglo XX .	" Alcázar de San Juan " es una ciudad de la comunidad autónoma de Castilla-La Mancha , ubicada en el noreste de la provincia de Ciudad Real .
La Unión Europea está compuesta por veintiocho estados europeos y fue establecida con la entrada en vigor del Tratado de la Unión Europea ( TUE ) , el 1 de noviembre de 1993 .	Sin embargo , con la entrada en vigor , el 1 de diciembre de 2009 , del Tratado de Lisboa , la Unión Europea sucedió , por completo aunque con ciertas particularidades , a las Comunidades Europeas y asumió con ello su personalidad jurídica única como sujeto de Derecho internacional .
Sin embargo , en el caso de los enteros es necesario calcular también el signo del resultado .	En la suma de dos números enteros , se determina por separado el signo y el valor absoluto del resultado .
La ciudad es también sede de las Cortes y la Junta de la comunidad autónoma de Castilla y León .	Valladolid alberga las sedes de las Cortes de Castilla y León y la Junta de Castilla y León , incluyendo la Presidencia de esta y sus doce consejerías .
En 1813 le fue concedido el título honorífico de " Libertador " por el Cabildo de Mérida en Venezuela que , tras serle ratificado en Caracas ese mismo año , quedó asociado a su nombre .	Así , en esta entrada triunfal se le concedió por primera vez el título de " El Libertador " , por decisión del Cabildo de Mérida .
Entre las especies más corrientes destacan " Agrostis castellana " y " Agrostis stolonifera " , esta última muy usada en campos de golf ya que es muy invasora y crea un tapete perfecto para la práctica de este deporte .	Las especies espontáneas en los pastizales de la Península Ibérica son abundantes , aunque de escaso valor nutritivo .
En sentido amplio , democracia es una forma de convivencia social en la que los miembros son libres e iguales y las relaciones sociales se establecen de acuerdo a mecanismos contractuales .	La " provincia de Almería " es una provincia española de la comunidad autónoma de Andalucía , situada en el sureste de la Península Ibérica .
El " axón " , " cilindroeje " o " neurita " es una prolongación de las neuronas especializadas en conducir el impulso nervioso desde el cuerpo celular o soma hacia otra célula .	El axón es una prolongación larga y delgada de las neuronas que se origina en una región especializada llamada eminencia axónica o cono axónico , a partir del soma , o a veces de una dendrita .
La biotecnología es ampliamente usada en agricultura , farmacia , ciencia de los alimentos , medio ambiente y medicina .	Para el siglo XVI Móstoles era un nudo de comunicaciones cuya importancia radicaba en ser la encrucijada de varias vías importantes .
" Ana María Matute Ausejo " ( Barcelona , 26 de julio de 1925 ) , novelista española , que es miembro de la Real Academia Española ( donde ocupa el asiento K ) y la tercera mujer que recibe el Premio Cervantes , obtenido en 2010 .	En 1996 publica " Olvidado Rey Gudú " y en 1998 es elegida académica de la Real Academia Española donde ocupa el asiento K , convirtiéndose en la tercera mujer que forma parte de esta institución .
Un " ensayo clínico " es una evaluación experimental de un producto , sustancia , medicamento , técnica diagnóstica o terapéutica que , en su aplicación a seres humanos , pretende valorar su eficacia y seguridad .	El " culombio " o " coulomb " ( símbolo " C " ) es la unidad derivada del sistema internacional para la medida de la magnitud física " cantidad de electricidad " ( carga eléctrica ) .
Los dinosaurios se clasifican tradicionalmente en dos grupos según la estructura de su cadera , los saurisquios y los ornitisquios .	Los dinosaurios están divididos en dos órdenes , Saurischia y Ornithischia , los cuales se basan en la estructura de la cadera .
El " wolframio " o " volframio " , también llamado " tungsteno " , es un elemento químico de número atómico 74 que se encuentra en el grupo 6 de la tabla periódica de los elementos .	" Democracia " es una forma de organización social que atribuye la titularidad del poder al conjunto de la sociedad .
Un compilador es un programa que permite traducir el código fuente de un programa en lenguaje de alto nivel , a otro lenguaje de nivel inferior ( típicamente lenguaje de máquina ) .	Surgió así por primera vez el concepto de un traductor como un programa que traducía un lenguaje a otro lenguaje .
El 18 de enero de 1535 , se efectuó la fundación española con el nombre de la " Ciudad de los Reyes " en la región agrícola conocida por los indígenas como " Limaq " , nombre que adquirió con el tiempo .	Así , el 18 de enero de 1535 se fundó Lima con el nombre de " Ciudad de los Reyes " .
El " presidente de la República de Chile " es el jefe de Estado y de Gobierno de Chile y su máxima autoridad política .	Desde el 11 de marzo de 2010 , el presidente de la República de Chile es Sebastián Piñera .
" Guerrero " es uno de los 31 estados que junto con el Distrito Federal conforman las 32 entidades federativas de México .	El Estado Libre y Soberano de Guerrero es una de las 32 entidades federativas de los Estados Unidos Mexicanos .
El sobrepeso y la obesidad son el quinto factor principal de riesgo de defunción en el mundo .	El exceso de peso corporal ( sobrepeso y obesidad ) produce mayor alteración en el Índice de Kupperman , metabolismo , sueño y calidad de vida .
La " chilena " es un género musical mexicano de la región de la Costa Chica , zona limítrofe entre los estados mexicanos del sur de Guerrero y Oaxaca , aunque su influencia se extiende a otras regiones cercanas del país .	La chilena surgió específicamente en lo que hoy comprende la Costa Chica de Guerrero y Oaxaca , en los distritos de Jamiltepec , Juquila y Pochutla ; sin embargo , muy pronto se expandió por toda la zona que se conoce como la Costa Chica , que comprende los estados de Guerrero y de Oaxaca , y por sí misma constituye una región cultural dentro del complejísimo y disímil pero interconectado territorio cultural de Guerrero-Oaxaca .
Las " ciencias de la Tierra " o " geociencias " son las disciplinas de las ciencias naturales que estudian la estructura , morfología , evolución y dinámica del planeta Tierra .	Las ciencias de la Tierra constituyen una herramienta para planificar una explotación racional de los recursos naturales , comprender las causas que originan los fenómenos naturales que afectan al ser humano y cómo el ser humano influye en la naturaleza con sus acciones .
Como hay muchos programas y el acceso al hardware es limitado , también se encarga de decidir qué programa podrá hacer uso de un dispositivo de hardware y durante cuánto tiempo , lo que se conoce como multiplexado .	El núcleo opera como asignador de recursos para cualquier proceso que necesite hacer uso de las facilidades de cómputo .
El municipio comienza en el volcán de Arafo y acaba en el barranco de Erques .	Dos accidentes naturales claramente definidos definen esta zona : La Ladera de Güímar ( al Norte ) y el Barranco de Erques o Herques ( al Sur ) .
Este realce no varía de lengua a lengua , pero suele incluir variación en el tono y duración de la sílaba .	La naturaleza fonética de dicho acento varía de lengua a lengua e incluye varios mecanismos como el tono , la intensidad y a veces la calidad y cantidad de la vocal o segmento que recibe el acento .
La " presión " ( símbolo " p " ) es una magnitud física que mide como la proyección de la fuerza en dirección perpendicular por unidad de superficie , y sirve para caracterizar cómo se aplica una determinada fuerza resultante sobre una línea .	La presión es la magnitud escalar que relaciona la fuerza con la superficie sobre la cual actúa , es decir , equivale a la fuerza que actúa sobre la superficie .
En la filosofía shramánica , " nirvana " es el estado de liberación tanto del sufrimiento ( dukkha ) como del ciclo de renacimientos .	Al igual que en el hinduismo , la realización del nirvana budista implica la liberación definitiva del sufrimiento de la existencia o de los diferentes estados de reencarnación a los que todos los seres están sujetos .
El " neutrón " es una partícula subatómica , un nucleón , sin carga neta , presente en el núcleo atómico de prácticamente todos los átomos , excepto el protio .	El neutrón es una partícula eléctricamente neutra , de masa 1.838,4 veces mayor que la del electrón y 1,00137 veces la del protón ; juntamente con los protones , los neutrones son los constitutivos fundamentales del núcleo atómico y se les considera como dos formas de una misma partícula : el nucleón .
El " cáncer " es una enfermedad provocada por un grupo de células que se multiplican sin control y de manera autónoma , invadiendo localmente y a distancia otros tejidos .	El cáncer es una enfermedad genética producida por la mutación en unos genes determinados .
A lo largo de su historia , los pueblos mesoamericanos construyeron una civilización cuyas expresiones hablan de elementos compartidos por varios pueblos y rasgos que los distinguen entre sí .	Los pueblos mesoamericanos constituyen un mosaico étnico y lingüístico que perdura hasta la actualidad .
" Daphne " es un género de plantas arbustivas propio de Eurasia establecido por Carlos Linneo en 1753 .	El género fue descrito por Carlos Linneo y publicado en " Species Plantarum . "
La " ontogenia " ( también llamada morfogénesis u ontogénesis ) describe el desarrollo de un organismo , desde el óvulo fertilizado hasta su senescencia , pasando por la forma adulta .	La idea de que la ontogenia recapitula la filogenia , esto es , que el desarrollo de un organismo refleje exactamente el desarrollo evolutivo de la especie , está hoy desacreditada .
Wikipedia no tiene reglas rígidas , pero se espera que los editores acaten los principios establecidos en políticas y convenciones , excepto cuando hay una buena razón para no hacerlo .	Esto significa que los editores individuales ( incluyéndote a " ti " ) hacen cumplir y aplican las políticas y convenciones .
El " Consejo de Seguridad de Naciones Unidas " es el organismo de las Naciones Unidas encargado de mantener la paz y seguridad entre las naciones .	El hijo de Rómulo , Numa Pompilio , en agradecimiento a la diosa , instaura el culto a las vestales .
A esta diferencia se le llama distancia de Hamming , y se define como el número de bits que tienen que cambiarse para transformar una palabra de código válida en otra palabra de código válida .	En Teoría de la Información se denomina " distancia de Hamming " a la efectividad de los códigos de bloque y depende de la diferencia entre una palabra de código válida y otra .
En física , la " fuerza " es una magnitud vectorial que mide la intensidad del intercambio de momento lineal entre dos partículas o sistemas de partículas .	Con el desarrollo de la electrodinámica cuántica , a mediados del siglo XX , se constató que la " fuerza " era una magnitud puramente macroscópica surgida de la conservación del momento lineal o cantidad de movimiento para partículas elementales .
El sobrepeso y la obesidad son el quinto factor principal de riesgo de defunción en el mundo .	Los organismos gubernamentales en EUA determinan el sobrepeso y la obesidad usando el índice de masa corporal ( IMC ) , utilizando el peso y altura para determinar la grasa corporal .
La " muerte " es un proceso terminal que consiste en la extinción del proceso homeostático de un ser vivo y , por ende , concluye con el fin de la vida .	Se suele decir que una de las características clave de la muerte es que es definitiva , y en efecto , los científicos no han sido capaces hasta ahora de presenciar la recomposición del proceso homeostático desde un punto termodinámicamente recuperable .
La sacarosa es un disacárido formado por una molécula de glucosa y una de fructosa , que se obtiene principalmente de la caña de azúcar o de la remolacha .	El azúcar es un endulzante de origen natural , sólido , cristalizado , constituido esencialmente por cristales sueltos de sacarosa , obtenidos a partir de la caña de azúcar " ( Saccharum officinarum L ) " o de la remolacha azucarera " ( Beta vulgaris L ) " mediante procedimientos industriales apropiados .
" El Señor de los Anillos " ( título original en inglés : " The Lord of the Rings " ) es una novela de fantasía épica escrita por el filólogo y escritor británico J. R. R. Tolkien .	" El Señor de los Anillos " fue iniciado como una secuela de " El hobbit " , una historia de fantasía publicada en 1937 y que en un principio había sido escrita por Tolkien para sus hijos .
Se denomina " comercio " a la actividad socioeconómica consistente en el intercambio de algunos materiales que sean libres en el mercado de compra y venta de bienes y servicios , sea para su uso , para su venta o su transformación .	El fundamento del capitalismo es el establecimiento de compañías especializadas en la compra , producción y venta de bienes y servicios , en un mercado libre del control del Estado .
La festividad de san Valentín era celebrada por la Iglesia Católica Romana cada 14 de febrero hasta 1969 en el calendario litúrgico tradicional , cuando fue eliminada esta fecha del calendario postconciliar .	Un kilobit por segundo es una unidad de medida que se usa en telecomunicaciones e informática para calcular la velocidad de transferencia de información a través de una red .
El 24 de febrero de 1530 , el mismo día de su cumpleaños , en Bolonia , Carlos fue coronado como emperador del Sacro Imperio Romano Germánico por el papa Clemente VII , quien se convirtió en aliado de la causa imperial .	Estado Plurinacional de Bolivia se encuentra en el hemisferio sur del planeta y al oeste del Meridiano de Greenwich por lo tanto tiene latitud sur y longitud occidental .
La " Comunidad de Madrid " es una comunidad autónoma de España situada en el centro de la Península Ibérica y , dentro de esta , en el centro de la Meseta Central .	También la Comunidad de Madrid es el organizador de la Copa Mundial de Clubes Sub-17 a nivel internacional .
El " cáncer " es una enfermedad provocada por un grupo de células que se multiplican sin control y de manera autónoma , invadiendo localmente y a distancia otros tejidos .	El crecimiento del cáncer es descontrolado y acelerado por un proceso de división celular continuo .
" La llamada de Cthulhu " es un juego de rol de horror ambientado en los años veinte y en particular en los « mitos de Cthulhu » , universo de ficción iniciado por el escritor estadounidense Howard Phillips Lovecraft .	" La llamada de Cthulhu " se apoya en los mitos de Cthulhu , el mundo creado por el escritor estadounidense Howard Phillips Lovecraft y un círculo de autores que se intercambiaban relatos entre ellos aproximadamente desde 1920 a 1930 .
" Gopher " es un servicio de Internet consistente en el acceso a la información a través de menús .	En gran medida acceder a un servidor de Gopher es parecido a utilizar un sitio FTP , ya que la información se presenta en menús que contienen archivos y carpetas .
Como un gas , un líquido es capaz de fluir y tomar la forma de un recipiente .	Como fluido sujeto a la fuerza de la gravedad , la forma de un líquido queda definida por su contenedor .
El equipo de fax receptor reconvierte la imagen codificada , y la imprime en papel .	El " flamenco " es un estilo de música y danza que se originó en Andalucía ( España ) .
En la actualidad , el Técnico Veterinario se ocupa también de la inspección y del control sanitario de los alimentos , la prevención de zoonosis .	Finalmente , el Técnico Veterinario está preparado para prestar colaboración en el control de la higiene ambiental , control de plagas , inspección y control de alimentos .
" Yves Henri Donat Mathieu Saint Laurent " ( Orán , Argelia , 1 de agosto de 1936 - París , 1 de junio de 2008 ) fue un diseñador de moda y empresario francés , fundador de la marca homónima de ropa de alta costura .	Yves Saint-Laurent falleció en París el 1 de junio de 2008 , a la edad de 71 años , tras una larga enfermedad de cáncer cerebral .
Cuanto más impura sea , más bajo es el punto de fusión y más amplia es la gama de variación .	En cambio , si hay impurezas , éstas provocan que el punto de fusión disminuya y el intervalo de fusión se amplíe .
El " presidente de la República de Chile " es el jefe de Estado y de Gobierno de Chile y su máxima autoridad política .	A consecuencia de ella , a partir de 1891 y hasta 1920 , el presidente se convirtió en un " Jefe de Estado , neutral frente a los partidos " , sin mayores atribuciones de gobierno , dentro de un régimen pseudoparlamentario .
En esta familia se incluyen especies alimenticias tan importantes como la papa o patata " ( Solanum tuberosum ) , " el tomate " ( Solanum lycopersicum " ) , la berenjena " ( Solanum melongena " ) y los ajíes o pimientos " ( Capsicum " ) .	Entre las solanáceas se cuentan especies alimenticias tan importantes para el ser humano como la patata o papa ( " Solanum tuberosum " ) , el tomate o jitomate ( " Solanum lycopersicum " ) , el chile , ají o pimiento ( " Capsicum annuum " ) o la berenjena ( " Solanum melongena " ) .
Sin embargo la microbiología tradicional se ha ocupado especialmente de los microorganismos patógenos entre bacterias , virus y hongos , dejando a otros microorganismos en manos de la parasitología y otras categorías de la biología .	Martinus Beijerinck hizo dos grandes contribuciones a la microbiología : el descubrimiento de los virus y el desarrollo de técnicas de cultivo microbiológico .
De hecho , para Occidente es el lugar de nacimiento de la democracia , la filosofía occidental , los Juegos Olímpicos , la literatura occidental y del estudio de la historia , la política y los más importantes principios de las matemáticas y de la ciencia .	Ambas , la Grecia clásica y la bizantina , representan para la mayoría de los griegos las precursoras de la actual República Helénica .
Las " iridáceas " ( " Iridaceae " ) son una familia de plantas perennes , herbáceas y bulbosas pertenecientes al orden de las Asparagales dentro de las monocotiledóneas .	Las iridáceas son plantas generalmente herbáceas y perennes , raramente anuales o arbustivas leñosas con crecimiento secundario anómalo .
La escritura decimal de un número racional es , o bien un número decimal finito , o bien periódico .	El " valor decimal " de un número racional , es simplemente el resultado de dividir el numerador entre el denominador .
La " trigonometría " es una rama de la matemática , cuyo significado etimológico es " la medición de los triángulos " .	La trigonometría es una rama importante de las matemáticas dedicada al estudio de la relación entre los lados y ángulos de un triángulo rectángulo y una circunferencia .
La película tuvo una buena acogida por el público y obtuvo 4 nominaciones a los Oscar de 1992 , de los que ganó tres : Mejor diseño de vestuario , Mejor Maquillaje y Mejor edición de sonido .	La película ganó tres premios de la academia : Mejor diseño de vestuario ( Eiko Ishioka ) , Mejor edición de sonido ( Tom C. McCarthy y David E. Stone ) y Mejor Maquillaje ( Greg Cannom , Michèle Burke , Matthew W. Mungle ) .
Maxwell se dio cuenta que la conservación de la carga eléctrica parecía requerir introducir un término adicional en la ley de Ampère .	Las " Fuerzas de Paz de la ONU " , popularmente conocidas como los " cascos azules " debido al color de los mismos , son cuerpos militares encargados de crear y mantener la paz en áreas de conflictos , monitorear y observar los procesos pacíficos y de brindar asistencia a ex combatientes en la implementación de tratados con fines pacíficos .
Usualmente , suele adherirse a la definición del Estado , el reconocimiento por parte de la comunidad internacional .	Hoy en día la doctrina aceptada para el reconocimiento de los Estados es la doctrina Estrada , pragmática en tanto en cuanto un sujeto no sea molesto para la sociedad internacional no va a tener dificultad para ser reconocido .
Tras solicitarlo , fue erigida como prelatura personal ( es decir , no territorial ) el 28 de noviembre de 1982 por el Papa Juan Pablo II , siendo la única existente en la actualidad .	La Constitución Apostólica " Ut Sit " erigió al Opus Dei como " prelatura personal de la Iglesia Católica " el 28 de noviembre de 1982 .
La denominación " rayos X " designa a una radiación electromagnética , invisible , capaz de atravesar cuerpos opacos y de imprimir las películas fotográficas .	Los rayos X son una radiación electromagnética de la misma naturaleza que las ondas de radio , las ondas de microondas , los rayos infrarrojos , la luz visible , los rayos ultravioleta y los rayos gamma .
" Wikipedia en español " es la versión en español de Wikipedia , un proyecto de enciclopedia web multilingüe de contenido libre basado en un modelo de edición abierta .	La Fundación Wikimedia ha creado , mantiene , y es responsable de una serie de proyectos web de contenido libre basados en un modelo de edición abierta « hermanos » de Wikipedia .
Habitualmente , se emplea el término para designar a la " taxonomía biológica " , la ciencia de ordenar la diversidad biológica en taxones anidados unos dentro de otros , ordenados de forma jerárquica , formando un sistema de clasificación .	Más allá de la escuela que la defina , la taxonomía es la ciencia que agrupa a los organismos en taxones anidados , ubicados en categorías taxonómicas , formando así un " sistema de clasificación " , que es el fin último de esta ciencia .
Su territorio está dividido en 23 provincias y una ciudad autónoma , Buenos Aires , capital de la nación y sede del gobierno federal .	El Senado reúne a los representantes de las 23 provincias y la Ciudad Autónoma de Buenos Aires , correspondiéndole a cada una dos senadores por la mayoría y uno por la minoría , sumando en total 72 miembros .
El teatro del absurdo es antipsicologista , por lo que no se mantiene la complejitad y riqueza psicológica del teatro anterior .	Portugal se ha convertido en una economía diversificada y cada vez más basada en el sector servicios desde que ingresó en la Unión Europea en 1986 .
Según el DRAE , la prostitución es la " actividad a la que se dedica quien mantiene relaciones sexuales con otras personas , a cambio de dinero " , aunque suele considerarse del mismo modo cualquier otro tipo de retribución .	Gibraltar es miembro asociado de la UEFA pero no es miembro de la FIFA .
" Guerrero " es uno de los 31 estados que junto con el Distrito Federal conforman las 32 entidades federativas de México .	Como artesanía , la alfarería en el estado de Guerrero es uno de los recursos culturales más comunes y utilizado en el diario vivir de los pobladores , como ollas , vasijas , jarros , candeleros .
" El Aljarafe " es una comarca histórica andaluza situada en la provincia de Sevilla , en Andalucía .	El Aljarafe es una comarca de gran riqueza agrícola que emerge entre los ríos Guadalquivir y su afluente el Guadiamar , y que es regada por varios arroyos .
La " Isla del Príncipe Eduardo " ( Nombre oficial en inglés : " Prince Edward Island " , y en francés : " Île-du-Prince-Édouard " ) es una de las provincias marítimas de Canadá .	Durante el invierno , la Isla del Príncipe Eduardo posee una temperatura media de -7 °C . La media de las mínimas es de -12 °C y la media de las máximas , de -3 °C . La temperatura más baja que se haya registrado en la provincia es de -37 °C , ocurrida en Alberton , el 26 de enero de 1884 .
" Neptuno " es el octavo planeta en distancia respecto al Sol y el más lejano del Sistema Solar .	Es el satélite más grande de Neptuno , y el más frío del sistema solar que haya sido observado por una Sonda ( -235º ) .
La palabra " judaísmo " se refiere a la religión , la tradición y la cultura del pueblo Judío .	La dramática marcha desde Egipto a través del mar Rojo y la peregrinación de 40 años por el desierto son hitos importantes en la historia del pueblo israelita .
El " himno de la Unión Europea " , oficialmente " Himno Europeo " , es uno de los cuatro símbolos oficiales de la Unión Europea .	El Consejo de Europa es una institución diferente al Consejo de la Unión Europea y agrupa a países miembros de la Unión , pero también a países que no lo son , es por ello que el himno es el mismo para el Consejo de Europa y para la UE .
El pueblo nicaragüense es de naturaleza multiétnica y principalmente de habla castellana , idioma que también es la lengua oficial del país .	De conformidad con el Artículo 11 de la Constitución de la República de Nicaragua , la lengua oficial del país es el idioma español .
Adicionalmente , en Wikipedia en español , todos los bibliotecarios también cumplen el rol de " burócratas " .	Aquellos usuarios con permisos de bibliotecario que no realicen cincuenta acciones administrativas en Wikipedia en español durante un periodo de dos años perderán de oficio sus permisos de bibliotecario .
El " papa " es el obispo de Roma , por lo que , como tal , recibe la consideración de cabeza visible de la Iglesia católica , cabeza del Colegio Episcopal ; jefe de Estado y soberano de la Ciudad del Vaticano .	Así el título de papa no es exclusivo de la Iglesia de Roma , pues era utilizado antiguamente por los principales patriarcas , hasta que fue cayendo en desuso , conservándolo sólo el patriarca de Occidente ( obispo de Roma ) y el patriarca de Alejandría , tanto el de la Iglesia copta como el de la Iglesia ortodoxa de Alejandría .
La " gastronomía de México " se caracteriza por su gran variedad de platillos y recetas , así como por la complejidad de elaboración de ciertos platillos .	La gastronomía mexicana , con su gran variedad de platillos tradicionales regionales , es rica en gusto , olor y colorido , orgullo del patrimonio cultural de la nación ; atributos que atraen por sí solo al turista .
Los servicios públicos de conmutación de paquetes admiten numerosos tipos de estaciones de distintos fabricantes .	Epiphany continuó con el motor de renderizado Gecko durante algún tiempo , hasta que se anunció su cambio al motor WebKit , utilizado , entre otros , por Safari y Google Chrome .
Los " géneros literarios " son los distintos grupos o categorías en que podemos clasificar las obras literarias atendiendo a su contenido .	Así mismo , y desde el punto de vista del autor , los géneros literarios son modelos de estructuración formal y temática que le permiten establecer un esquema previo a la creación de su obra .
Las fronteras de Europa y la población son objeto de controversia , ya que el término continente puede referirse a un bien cultural y político o a distinciones fisiográficas .	El término " Europa " tiene diversos usos , y los principales son de carácter geográfico y político .
La máxima autoridad del Vaticano y jefe de Estado del mismo es el sumo pontífice , por lo que puede considerarse la única teocracia de Europa .	La esencia del Estado de la Ciudad del Vaticano se fundamenta en su unión con la Santa Sede , de manera que el Papa es a la vez Cabeza Suprema de la organización católica romana y Jefe de Estado del Estado de la Ciudad del Vaticano .
El ecuador divide la superficie del planeta en dos partes , el hemisferio norte y el hemisferio sur .	Los otros cuatro " círculos " notables son los dos círculos polares y los dos círculos tropicales ( Trópico de Cáncer en el hemisferio norte y Trópico de Capricornio en el hemisferio sur ) .
La forma es la suma de un arco multicolor con el rojo hacia la parte exterior y el violeta hacia la interior .	Menos frecuente es el arco iris doble , el cual incluye un segundo arco más tenue con los colores invertidos , es decir , el rojo hacia el interior y el violeta hacia el exterior .
La " Isla del Príncipe Eduardo " ( Nombre oficial en inglés : " Prince Edward Island " , y en francés : " Île-du-Prince-Édouard " ) es una de las provincias marítimas de Canadá .	La Isla del Príncipe Eduardo , debido a su localización ( rodeada por grandes cuerpos de agua ) posee un clima más estable y ameno que el resto del país , registrando las temperaturas más altas de Canadá durante el invierno y las más bajas durante el verano .
La " historia de la Argentina " es la cronología de sucesos acaecidos desde el comienzo del primigenio poblamiento humano en el actual territorio de la República Argentina hasta nuestros días .	Hahnemann propuso la homeopatía como una alternativa más benigna y moderada a la medicina de la época , que estaba basada aún en la teoría de los humores hipocrática y utilizaba la sangría y la purgación como herramientas principales .
Constantemente es clasificada entre las mejores universidades de Europa septentrional , y generalmente se le considera como una de las instituciones de educación superior más prestigiosas del viejo continente .	La Universidad de Uppsala constantemente es considerada como una de las universidades más prestigiosas de Europa y del país .
Un " mes " ( del latín " mensis " ) es cada uno de los doce períodos de tiempo , de entre 28 y 31 días , en que se divide el año .	Por lo tanto puede tener un valor de 28 , 29 , 30 o 31 días en función del mes en el que se utilice el término .
Un " canal de comunicación " es el medio de transmisión por el que viajan las señales portadoras de la información emisor y receptor .	La Monarquía Católica o Monarquía Hispánica del rey Carlos I se completó cuando el monarca fue proclamado emperador del Sacro Imperio bajo el nombre de Carlos V. El emperador asumió -entre otros compromisos- el de convocar asambleas de los estados denominadas reuniones o dietas .
El manual de GNU Emacs lo describe como " un editor extensible , personalizable , auto-documentado y de tiempo real . "	" Windows 2000 " es un sistema operativo de Microsoft que se puso en circulación el 17 de febrero de 2000 con un cambio de nomenclatura para su sistema NT .
Varios siglos después , en el año 711 los musulmanes ocuparon la ciudad , aportando su lengua , religión y costumbres , como la implantación de sistemas de riego y la introducción de nuevos cultivos .	El " Sistema Métrico Decimal " es un sistema de unidades basado en el metro , medida de longitud , y en el cual las unidades de mayor o menor tamaño de cada unidad de medida están relacionadas entre sí por múltiplos o submúltiplos de 10 , respectivamente .
Se denomina " día " ( del latín " dies " ) al lapso que tarda la Tierra desde que el sol está en el punto más alto sobre el horizonte hasta que vuelve a estarlo .	También se conoce como día , de manera genérica , al lapso que va desde la salida del Sol a su ocaso .
La " Organización Mundial de la Salud ( OMS ) " , es el organismo de la Organización de las Naciones Unidas ( ONU ) especializado en gestionar políticas de prevención , promoción e intervención en salud a nivel mundial .	El equipo de fax receptor reconvierte la imagen codificada , y la imprime en papel .
A diferencia de sus contemporáneos , nunca realizó un viaje formativo a Italia para conocer el arte clásico , y su carrera destaca por cierta indiferencia hacia las ambiciones cortesanas o intelectuales .	De su aprendizaje , debemos destacar que Jordaens , a diferencia de Rubens y Van Dyck , no realizará un viaje a Italia .
Consiste en una caja cerrada y un pequeño agujero por el que entra una pequeña cantidad de luz que proyecta en la pared opuesta la imagen del exterior .	El " potencial eléctrico " o " potencial electrostático " en un punto , es el trabajo que debe realizar un campo electrostático para mover una carga positiva " q " desde dicho punto hasta el punto de referencia , dividido por unidad de carga de prueba .
